ACTTGCTCCAGAGCATGAATGTAT -> CTTGCTCCAGAGCATGAATGTATG
CATCCGGCCGAAGTGTATGTCTAG -> ATCCGGCCGAAGTGTATGTCTAGA
ATTCATCTACTCCACCGCAGTACG -> TTCATCTACTCCACCGCAGTACGT
AATGATGAGCTAAATAGCGAACTA -> ATGATGAGCTAAATAGCGAACTAA
ACCTTCACCTTAAGCCCGTAATTA -> CCTTCACCTTAAGCCCGTAATTAT
AGCGCACCATTAGAGAAGCCCTAT -> GCGCACCATTAGAGAAGCCCTATC
CCTTTTGTACAGTTCGTTTAGTTA -> CTTTTGTACAGTTCGTTTAGTTAG
ATAAATTCAACTGCCTCGCCAGCA -> TAAATTCAACTGCCTCGCCAGCAC
AATGAGGGGCTAGTCAGGGACATA -> ATGAGGGGCTAGTCAGGGACATAG
CAGATGAGACAACAAAGAATGAAC -> AGATGAGACAACAAAGAATGAACG
GTAGGTCGAATGAGGGGCTAGTCA -> TAGGTCGAATGAGGGGCTAGTCAG
AACCTACCGATTCTGTTAAGGCGT -> ACCTACCGATTCTGTTAAGGCGTC
CTGGTGAGTGAATCGTCCGGCCGC -> TGGTGAGTGAATCGTCCGGCCGCG
GGCCTCTTTAGAGTTGGCCACCCA -> GCCTCTTTAGAGTTGGCCACCCAG
CCTACGCAGGATATTTTCTACAAT -> CTACGCAGGATATTTTCTACAATT
GTAATTATTCATCTACTCCACCGC -> TAATTATTCATCTACTCCACCGCA
TCATCGAAAGACTTTGGCGTTCCG -> CATCGAAAGACTTTGGCGTTCCGA
GCGTACAGAGTCCCCCGCGGCACT -> CGTACAGAGTCCCCCGCGGCACTG
TTAGAGTTGGCCACCCAGGATTGG -> TAGAGTTGGCCACCCAGGATTGGC
AACCGGACATCTACAACATCTCGC -> ACCGGACATCTACAACATCTCGCC
ATAACCATTTTATGTTGTAATTCA -> TAACCATTTTATGTTGTAATTCAA
GTTAGAGGCCAGCTCCGCGGCCGG -> TTAGAGGCCAGCTCCGCGGCCGGG
GGAACAACCAGGGCGGCAGCCCAG -> GAACAACCAGGGCGGCAGCCCAGA
TTGACCTGGGCAAACCTACCGATT -> TGACCTGGGCAAACCTACCGATTC
CTACCACGGGCAAGTTACATTGGT -> TACCACGGGCAAGTTACATTGGTG
ACCACTCGTCGTGCGCGCGTACGC -> CCACTCGTCGTGCGCGCGTACGCC
TAAATAGCGAACTAATAAGCCCTT -> AAATAGCGAACTAATAAGCCCTTG
CCGCTTAGGTGTATAAAAGTCAGA -> CGCTTAGGTGTATAAAAGTCAGAG
TTGCCTAAACGTCGTCGGAAGACA -> TGCCTAAACGTCGTCGGAAGACAG
GCCGAAGTGTATGTCTAGAGGGGG -> CCGAAGTGTATGTCTAGAGGGGGG
AGTAACGTGACAAGTTGGGTGGCT -> GTAACGTGACAAGTTGGGTGGCTG
AAATACGGCACTTGGGAAGTCCCA -> AATACGGCACTTGGGAAGTCCCAA
TTTTTATGCAACTATAGTGCGCCG -> TTTTATGCAACTATAGTGCGCCGA
AATAGCGAACTAATAAGCCCTTGT -> ATAGCGAACTAATAAGCCCTTGTA
CAACTTTGAAGATAATCGTTTCGA -> AACTTTGAAGATAATCGTTTCGAT
GCCAGCACATCATATGTGTCGTGA -> CCAGCACATCATATGTGTCGTGAA
GGGGCTAGTCAGGGACATAGTTGT -> GGGCTAGTCAGGGACATAGTTGTA
ACCTACCGATTCTGTTAAGGCGTC -> CCTACCGATTCTGTTAAGGCGTCA
GCCACCGTTATTTCGCGTTTCTCA -> CCACCGTTATTTCGCGTTTCTCAG
CCACCCAGGATTGGCGCATACACG -> CACCCAGGATTGGCGCATACACGA
GAATGTATGTTGAACCGGACATCT -> AATGTATGTTGAACCGGACATCTA
ATTCCTTGGCTTTGTCTACTAGCC -> TTCCTTGGCTTTGTCTACTAGCCA
TACAACATCTCGCCGTTGGGAGCG -> ACAACATCTCGCCGTTGGGAGCGA
GGATCCCCAACTGATCGGCTTCAC -> GATCCCCAACTGATCGGCTTCACC
GGGAGCGATGACCTACAGCGCAGT -> GGAGCGATGACCTACAGCGCAGTA
GAGCTAAATAGCGAACTAATAAGC -> AGCTAAATAGCGAACTAATAAGCC
TCTACAATTTGGAGTCATGAGCCG -> CTACAATTTGGAGTCATGAGCCGG
GATGAGCTAAATAGCGAACTAATA -> ATGAGCTAAATAGCGAACTAATAA
TTCTGGTGGACGCTCCTCCGTGGA -> TCTGGTGGACGCTCCTCCGTGGAG
AGCCCTATCGCCGTTTTGTAATTT -> GCCCTATCGCCGTTTTGTAATTTT
CCGTGGAGGAAAATACGGCACTTG -> CGTGGAGGAAAATACGGCACTTGG
GCTGTTGTCCGATAACACAAACAG -> CTGTTGTCCGATAACACAAACAGT
TCCCCAACTGATCGGCTTCACCGC -> CCCCAACTGATCGGCTTCACCGCT
CTACCCACTAGTGTTTAATAACCA -> TACCCACTAGTGTTTAATAACCAT
CGGCAGCCCAGAATCCCGTATCCC -> GGCAGCCCAGAATCCCGTATCCCA
CGTATACGGGTATCTAATTACCAG -> GTATACGGGTATCTAATTACCAGA
ACCGCCATAAGTCCTTCTAACGAC -> CCGCCATAAGTCCTTCTAACGACT
GTCCTTCTAAGCGTTCCATGGGTC -> TCCTTCTAAGCGTTCCATGGGTCC
CCTCCGTGGAGGACCACTCGTCGT -> CTCCGTGGAGGACCACTCGTCGTG
GAATCCCGTATCCCAATAATTCCG -> AATCCCGTATCCCAATAATTCCGA
GCTTTGTCTACTAGCCAAAGTTCG -> CTTTGTCTACTAGCCAAAGTTCGC
GGGCTTTCACTATTAAACCCTTAT -> GGCTTTCACTATTAAACCCTTATC
AGTGCGATGCGTGGATCATGCCAT -> GTGCGATGCGTGGATCATGCCATC
GCTTACCGCCGGCTCGATGCTCGT -> CTTACCGCCGGCTCGATGCTCGTC
GCACATCATATGTGTCGTGAAGAG -> CACATCATATGTGTCGTGAAGAGG
TCGTCCGGCCGCGTGCACGATACC -> CGTCCGGCCGCGTGCACGATACCC
AGTGCCCTACCCCCAGGTCCTTCT -> GTGCCCTACCCCCAGGTCCTTCTA
TCTAAGCGTTCCATGGGTCCCGTC -> CTAAGCGTTCCATGGGTCCCGTCG
GCACTACCACGGGCAAGTTACATT -> CACTACCACGGGCAAGTTACATTG
AACCAGGGCGGCAGCCCAGAATCC -> ACCAGGGCGGCAGCCCAGAATCCC
GTCTTCTGGTGGACGCTCCTCCGT -> TCTTCTGGTGGACGCTCCTCCGTG
TCTTTAGAGTTGGCCACCCAGGAT -> CTTTAGAGTTGGCCACCCAGGATT
ACTGACCTACGATATTTCGCACTA -> CTGACCTACGATATTTCGCACTAC
ACATTGGTGTCATCGAAAGACTTT -> CATTGGTGTCATCGAAAGACTTTG
TGGATGACGCGTATACGGGTATCT -> GGATGACGCGTATACGGGTATCTA
GAGCGCACCATTAGAGAAGCCCTA -> AGCGCACCATTAGAGAAGCCCTAT
AGAATGAACGCAGTGCCCTACCCC -> GAATGAACGCAGTGCCCTACCCCC
AAGGTACGTAGAAAATACCAGGAC -> AGGTACGTAGAAAATACCAGGACA
TTCTAAGCGTTCCATGGGTCCCGT -> TCTAAGCGTTCCATGGGTCCCGTC
CATCTCGCCGTTGGGAGCGATGAC -> ATCTCGCCGTTGGGAGCGATGACC
TATTTCGCGTTTCTCAGTGTTGAT -> ATTTCGCGTTTCTCAGTGTTGATT
CATGAGCCGGACCTTTTGTACAGT -> ATGAGCCGGACCTTTTGTACAGTT
AAGGTCTCGTCTCACACTGGATCG -> AGGTCTCGTCTCACACTGGATCGC
ACGCCACATCCTGTTCACCGCTTA -> CGCCACATCCTGTTCACCGCTTAG
TTGGAGTCATGAGCCGGACCTTTT -> TGGAGTCATGAGCCGGACCTTTTG
CTCGCCGTTGGGAGCGATGACCTA -> TCGCCGTTGGGAGCGATGACCTAC
GAACACCGTTATGACCGCCATAAG -> AACACCGTTATGACCGCCATAAGT
AGGCCCCGCACCTTGCACACACTA -> GGCCCCGCACCTTGCACACACTAG
TCATGGGGAAAGAGCGCACCATTA -> CATGGGGAAAGAGCGCACCATTAG
TGTTTAATAACCATTTTATGTTGT -> GTTTAATAACCATTTTATGTTGTA
GTCCTCATGGAGGCCCCGCACCTT -> TCCTCATGGAGGCCCCGCACCTTG
TCGCCGTTTTGTAATTTTTATGCA -> CGCCGTTTTGTAATTTTTATGCAA
CCAACTGATCGGCTTCACCGCTGC -> CAACTGATCGGCTTCACCGCTGCC
GACTTGCTCCAGAGCATGAATGTA -> ACTTGCTCCAGAGCATGAATGTAT
CACCGCTGCCCCCCCCATGCTCGG -> ACCGCTGCCCCCCCCATGCTCGGC
AGTCAGGGACATAGTTGTACTTCA -> GTCAGGGACATAGTTGTACTTCAC
CAGGACGCGTCGGAAGGTACGTAG -> AGGACGCGTCGGAAGGTACGTAGA
AGCATGAATGTATGTTGAACCGGA -> GCATGAATGTATGTTGAACCGGAC
TACCTTCACCTTAAGCCCGTAATT -> ACCTTCACCTTAAGCCCGTAATTA
TGGGCAAACCTACCGATTCTGTTA -> GGGCAAACCTACCGATTCTGTTAA
CACACACTAGGGCTACCCGTATCT -> ACACACTAGGGCTACCCGTATCTC
ACTAGTGGGACTGGTGAGTGAATC -> CTAGTGGGACTGGTGAGTGAATCG
GTCAAATTTTCTCACTTTTGTGAA -> TCAAATTTTCTCACTTTTGTGAAG
AATAACCATTTTATGTTGTAATTC -> ATAACCATTTTATGTTGTAATTCA
AGTGTATGTCTAGAGGGGGGAGTC -> GTGTATGTCTAGAGGGGGGAGTCT
GCAGTCCTTTCAGGACGCGTCGGA -> CAGTCCTTTCAGGACGCGTCGGAA
ACATAGTTGTACTTCACTAGTGGG -> CATAGTTGTACTTCACTAGTGGGA
CCAGTAAGGAACACCGTTATGACC -> CAGTAAGGAACACCGTTATGACCG
CGGCCTCTTTAGAGTTGGCCACCC -> GGCCTCTTTAGAGTTGGCCACCCA
TGCGACAGCAATGATGAGCTAAAT -> GCGACAGCAATGATGAGCTAAATA
CAGGCGAACTGCAGGAAAATAACC -> AGGCGAACTGCAGGAAAATAACCA
TGGTATGCTTACCGCCGGCTCGAT -> GGTATGCTTACCGCCGGCTCGATG
CAACAAAGAATGAACGCAGTGCCC -> AACAAAGAATGAACGCAGTGCCCT
CAGGTCCTTCTAAGCGTTCCATGG -> AGGTCCTTCTAAGCGTTCCATGGG
TTATTCATCTACTCCACCGCAGTA -> TATTCATCTACTCCACCGCAGTAC
TCTCACACTGGATCGCATCCGGCC -> CTCACACTGGATCGCATCCGGCCG
AAAGAATGAACGCAGTGCCCTACC -> AAGAATGAACGCAGTGCCCTACCC
CCCCAACTGATCGGCTTCACCGCT -> CCCAACTGATCGGCTTCACCGCTG
GTATCCCAATAATTCCGAAGACAG -> TATCCCAATAATTCCGAAGACAGG
AAGGTAATGGTTCAGATGCACTCC -> AGGTAATGGTTCAGATGCACTCCC
CATTGGTGTCATCGAAAGACTTTG -> ATTGGTGTCATCGAAAGACTTTGG
GACATAGTTGTACTTCACTAGTGG -> ACATAGTTGTACTTCACTAGTGGG
AGTCAGAGGAGCTGAGCGTCGACT -> GTCAGAGGAGCTGAGCGTCGACTC
CCTTCTAACGACTGAGGTTGGCCC -> CTTCTAACGACTGAGGTTGGCCCT
GGCACTGAGGCAGTAGTGGTATGC -> GCACTGAGGCAGTAGTGGTATGCT
AGGCGTCATCCTGTAGGTCGAATG -> GGCGTCATCCTGTAGGTCGAATGA
AGGAATCCACCAGCCTAGTGTTCG -> GGAATCCACCAGCCTAGTGTTCGC
GAGGAGCTGAGCGTCGACTCTACC -> AGGAGCTGAGCGTCGACTCTACCA
CTCAGTGTTGATTGATGCGGCTAC -> TCAGTGTTGATTGATGCGGCTACA
TTTTGAGAGGAATCCACCAGCCTA -> TTTGAGAGGAATCCACCAGCCTAG
TTTCGCACTACCACGGGCAAGTTA -> TTCGCACTACCACGGGCAAGTTAC
TCTAATTACCAGAGCACAAGCCGA -> CTAATTACCAGAGCACAAGCCGAC
CGTTCCATGGGTCCCGTCGGGCAT -> GTTCCATGGGTCCCGTCGGGCATA
GTTCCGACTGGCTGGAGCCGTGGA -> TTCCGACTGGCTGGAGCCGTGGAG
TCGTCTCACACTGGATCGCATCCG -> CGTCTCACACTGGATCGCATCCGG
GATGCGGCTACATGGAACGGGATT -> ATGCGGCTACATGGAACGGGATTC
AGTTACATTGGTGTCATCGAAAGA -> GTTACATTGGTGTCATCGAAAGAC
AACCATTTTATGTTGTAATTCAAC -> ACCATTTTATGTTGTAATTCAACG
GTTGTACTCGTGCAGTCCTTTCAG -> TTGTACTCGTGCAGTCCTTTCAGG
CGATGCGTGGATCATGCCATCTAT -> GATGCGTGGATCATGCCATCTATA
TCGCTTTTTGAGAGGAATCCACCA -> CGCTTTTTGAGAGGAATCCACCAG
AGAGCACAAGCCGACGATCGGCCT -> GAGCACAAGCCGACGATCGGCCTT
ACCGTTATTTCGCGTTTCTCAGTG -> CCGTTATTTCGCGTTTCTCAGTGT
GGATCATGCCATCTATATAGTCAA -> GATCATGCCATCTATATAGTCAAA
CTTTCAGGACGCGTCGGAAGGTAC -> TTTCAGGACGCGTCGGAAGGTACG
GAGTTGGCCACCCAGGATTGGCGC -> AGTTGGCCACCCAGGATTGGCGCA
GGCGCATACACGATCTGGTCTTCT -> GCGCATACACGATCTGGTCTTCTG
CCAGAGCACAAGCCGACGATCGGC -> CAGAGCACAAGCCGACGATCGGCC
TGGTTCAGATGCACTCCCCTCGTA -> GGTTCAGATGCACTCCCCTCGTAC
GGATGACGCGTATACGGGTATCTA -> GATGACGCGTATACGGGTATCTAA
TAGTGTTTAATAACCATTTTATGT -> AGTGTTTAATAACCATTTTATGTT
GCTCGGCGTACAGAGTCCCCCGCG -> CTCGGCGTACAGAGTCCCCCGCGG
AAAGGTAATGGTTCAGATGCACTC -> AAGGTAATGGTTCAGATGCACTCC
CGCGGCCGGGCCCAAAAGGTAATG -> GCGGCCGGGCCCAAAAGGTAATGG
TACAATTTGGAGTCATGAGCCGGA -> ACAATTTGGAGTCATGAGCCGGAC
GAGCCCGCCGTAGAGGCTTCCAGC -> AGCCCGCCGTAGAGGCTTCCAGCT
TACAGTTCGTTTAGTTAGAGGCCA -> ACAGTTCGTTTAGTTAGAGGCCAG
CAAATTTTCTCACTTTTGTGAAGG -> AAATTTTCTCACTTTTGTGAAGGT
AAATAACCAGATGAGACAACAAAG -> AATAACCAGATGAGACAACAAAGA
GAGTGAATCGTCCGGCCGCGTGCA -> AGTGAATCGTCCGGCCGCGTGCAC
GCCGCATGCGACAGCAATGATGAG -> CCGCATGCGACAGCAATGATGAGC
CCTTTATAAATTTACCTTCACCTT -> CTTTATAAATTTACCTTCACCTTA
AGAGCATGAATGTATGTTGAACCG -> GAGCATGAATGTATGTTGAACCGG
TTGGCCCTTCATTTAGCAAATTCA -> TGGCCCTTCATTTAGCAAATTCAT
GCAGCCCAGAATCCCGTATCCCAA -> CAGCCCAGAATCCCGTATCCCAAT
GACGCGTCGGAAGGTACGTAGAAA -> ACGCGTCGGAAGGTACGTAGAAAA
GTCGGGCATAAATTCAACTGCCTC -> TCGGGCATAAATTCAACTGCCTCG
GCGTGGATCATGCCATCTATATAG -> CGTGGATCATGCCATCTATATAGT
GTACAGTTCGTTTAGTTAGAGGCC -> TACAGTTCGTTTAGTTAGAGGCCA
GCCATAGTCGGCGGGAGCCGCATG -> CCATAGTCGGCGGGAGCCGCATGC
CAAGTTGGGTGGCTGCCGGATCCC -> AAGTTGGGTGGCTGCCGGATCCCC
CTTCCAGCTTGAGGATTTAGGGCT -> TTCCAGCTTGAGGATTTAGGGCTT
TAGTTGGACTGTTGGCGTTGTACT -> AGTTGGACTGTTGGCGTTGTACTC
AGCAATGATGAGCTAAATAGCGAA -> GCAATGATGAGCTAAATAGCGAAC
CTACCAGTAAGGAACACCGTTATG -> TACCAGTAAGGAACACCGTTATGA
CGCGCGTACGCCACATCCTGTTCA -> GCGCGTACGCCACATCCTGTTCAC
TCGTACTTTGGTAGATACAGACGG -> CGTACTTTGGTAGATACAGACGGG
CGTTCCGACTGGCTGGAGCCGTGG -> GTTCCGACTGGCTGGAGCCGTGGA
CTTCAAGTGCGATGCGTGGATCAT -> TTCAAGTGCGATGCGTGGATCATG
AATACCAGGACAATTTGTGGTCAA -> ATACCAGGACAATTTGTGGTCAAC
GCCTAAACGTCGTCGGAAGACAGA -> CCTAAACGTCGTCGGAAGACAGAC
AGTCGGCGGGAGCCGCATGCGCTA -> GTCGGCGGGAGCCGCATGCGCTAC
TATATAGTCAAATTTTCTCACTTT -> ATATAGTCAAATTTTCTCACTTTT
TTTGTGGTCAACAGGCGAACTGCA -> TTGTGGTCAACAGGCGAACTGCAG
GCGAACTGCAGGAAAATAACCAGA -> CGAACTGCAGGAAAATAACCAGAT
GCTACCAGTAAGGAACACCGTTAT -> CTACCAGTAAGGAACACCGTTATG
TGAGAGGAATCCACCAGCCTAGTG -> GAGAGGAATCCACCAGCCTAGTGT
CAGTGGCGGCCTCTTTAGAGTTGG -> AGTGGCGGCCTCTTTAGAGTTGGC
CTACTAGCCAAAGTTCGCTTTTTG -> TACTAGCCAAAGTTCGCTTTTTGA
TTCAAGTGCGATGCGTGGATCATG -> TCAAGTGCGATGCGTGGATCATGC
CAACCAGGGCGGCAGCCCAGAATC -> AACCAGGGCGGCAGCCCAGAATCC
ACCGTTATGACCGCCATAAGTCCT -> CCGTTATGACCGCCATAAGTCCTT
GCGTACGCCACATCCTGTTCACCG -> CGTACGCCACATCCTGTTCACCGC
AAGTTCGCTTTTTGAGAGGAATCC -> AGTTCGCTTTTTGAGAGGAATCCA
GTGGACGCTCCTCCGTGGAGGACC -> TGGACGCTCCTCCGTGGAGGACCA
TCACTAGTGGGACTGGTGAGTGAA -> CACTAGTGGGACTGGTGAGTGAAT
ACCAGCCTAGTGTTCGCCTGCCCG -> CCAGCCTAGTGTTCGCCTGCCCGA
GCACTGAGGCAGTAGTGGTATGCT -> CACTGAGGCAGTAGTGGTATGCTT
AAACCTACCGATTCTGTTAAGGCG -> AACCTACCGATTCTGTTAAGGCGT
GCGATGACCTACAGCGCAGTAACG -> CGATGACCTACAGCGCAGTAACGT
GAGGAAAATACGGCACTTGGGAAG -> AGGAAAATACGGCACTTGGGAAGT
TACGTAGAAAATACCAGGACAATT -> ACGTAGAAAATACCAGGACAATTT
TACGATATTTCGCACTACCACGGG -> ACGATATTTCGCACTACCACGGGC
CCCAGAATCCCGTATCCCAATAAT -> CCAGAATCCCGTATCCCAATAATT
GTACGCCACATCCTGTTCACCGCT -> TACGCCACATCCTGTTCACCGCTT
GCGGCACTGAGGCAGTAGTGGTAT -> CGGCACTGAGGCAGTAGTGGTATG
GCCGCATGCGCTACCCATAATACA -> CCGCATGCGCTACCCATAATACAC
AGATGTTGCCTAAACGTCGTCGGA -> GATGTTGCCTAAACGTCGTCGGAA
TGTATGTCTAGAGGGGGGAGTCTA -> GTATGTCTAGAGGGGGGAGTCTAC
GAACCGGACATCTACAACATCTCG -> AACCGGACATCTACAACATCTCGC
CTCGTACTTTGGTAGATACAGACG -> TCGTACTTTGGTAGATACAGACGG
TCGTGAAGAGGAGATGTTGCCTAA -> CGTGAAGAGGAGATGTTGCCTAAA
GTATCTCTGAGCCCGCCGTAGAGG -> TATCTCTGAGCCCGCCGTAGAGGC
CAGAGCATGAATGTATGTTGAACC -> AGAGCATGAATGTATGTTGAACCG
TGTTGCCTAAACGTCGTCGGAAGA -> GTTGCCTAAACGTCGTCGGAAGAC
ATATTTCGCACTACCACGGGCAAG -> TATTTCGCACTACCACGGGCAAGT
TGGCGCATACACGATCTGGTCTTC -> GGCGCATACACGATCTGGTCTTCT
ATGACCTACAGCGCAGTAACGTGA -> TGACCTACAGCGCAGTAACGTGAC
GATACAGACGGGAAGCCATAGTCG -> ATACAGACGGGAAGCCATAGTCGG
TGTTGTAATTCAACGGGAACAACC -> GTTGTAATTCAACGGGAACAACCA
TCATCCTGTAGGTCGAATGAGGGG -> CATCCTGTAGGTCGAATGAGGGGC
GAAGTCCCAACTTTGAAGATAATC -> AAGTCCCAACTTTGAAGATAATCG
GCCGTGGAGGAAAATACGGCACTT -> CCGTGGAGGAAAATACGGCACTTG
TTGAACCGGACATCTACAACATCT -> TGAACCGGACATCTACAACATCTC
GGGAAGTCCCAACTTTGAAGATAA -> GGAAGTCCCAACTTTGAAGATAAT
GTCGTGCGCGCGTACGCCACATCC -> TCGTGCGCGCGTACGCCACATCCT
ACCGCAGTACGTGCATAGGTCGTC -> CCGCAGTACGTGCATAGGTCGTCT
TGGGAGCGATGACCTACAGCGCAG -> GGGAGCGATGACCTACAGCGCAGT
TGCTCGTCCTCATGGAGGCCCCGC -> GCTCGTCCTCATGGAGGCCCCGCA
TTTTCTCACTTTTGTGAAGGTCTC -> TTTCTCACTTTTGTGAAGGTCTCG
TTGTGGTCAACAGGCGAACTGCAG -> TGTGGTCAACAGGCGAACTGCAGG
GTGCGCCGACGTAATGCCTGCTGG -> TGCGCCGACGTAATGCCTGCTGGA
CTTCATTTAGCAAATTCATGGGGA -> TTCATTTAGCAAATTCATGGGGAA
TGTTGATTGATGCGGCTACATGGA -> GTTGATTGATGCGGCTACATGGAA
GCAAATTCATGGGGAAAGAGCGCA -> CAAATTCATGGGGAAAGAGCGCAC
CTAGTGTTTAATAACCATTTTATG -> TAGTGTTTAATAACCATTTTATGT
GCAGTACGTGCATAGGTCGTCTTG -> CAGTACGTGCATAGGTCGTCTTGA
CCAGCTCCGCGGCCGGGCCCAAAA -> CAGCTCCGCGGCCGGGCCCAAAAG
GGCCGAAGTGTATGTCTAGAGGGG -> GCCGAAGTGTATGTCTAGAGGGGG
GTCCGGCCGCGTGCACGATACCCA -> TCCGGCCGCGTGCACGATACCCAC
GCCAGCTCCGCGGCCGGGCCCAAA -> CCAGCTCCGCGGCCGGGCCCAAAA
ATAACACAAACAGTGGCGGCCTCT -> TAACACAAACAGTGGCGGCCTCTT
CCGCTGCCCCCCCCATGCTCGGCG -> CGCTGCCCCCCCCATGCTCGGCGT
CATGGAGGCCCCGCACCTTGCACA -> ATGGAGGCCCCGCACCTTGCACAC
TGTGGTCAACAGGCGAACTGCAGG -> GTGGTCAACAGGCGAACTGCAGGA
ACAGAGTCCCCCGCGGCACTGAGG -> CAGAGTCCCCCGCGGCACTGAGGC
GGGCAAGTTACATTGGTGTCATCG -> GGCAAGTTACATTGGTGTCATCGA
CCGTTATTTCGCGTTTCTCAGTGT -> CGTTATTTCGCGTTTCTCAGTGTT
GGAGCATTTCGCTGTTGTCCGATA -> GAGCATTTCGCTGTTGTCCGATAA
CAGGAAAATAACCAGATGAGACAA -> AGGAAAATAACCAGATGAGACAAC
GCGCATACACGATCTGGTCTTCTG -> CGCATACACGATCTGGTCTTCTGG
GTAGTTGGACTGTTGGCGTTGTAC -> TAGTTGGACTGTTGGCGTTGTACT
GATAACACAAACAGTGGCGGCCTC -> ATAACACAAACAGTGGCGGCCTCT
ACCGCTGCCCCCCCCATGCTCGGC -> CCGCTGCCCCCCCCATGCTCGGCG
GCATAGGTCGTCTTGACCTGGGCA -> CATAGGTCGTCTTGACCTGGGCAA
AACACAAACAGTGGCGGCCTCTTT -> ACACAAACAGTGGCGGCCTCTTTA
ACAGACGGGAAGCCATAGTCGGCG -> CAGACGGGAAGCCATAGTCGGCGG
TGGTGGACGCTCCTCCGTGGAGGA -> GGTGGACGCTCCTCCGTGGAGGAC
GTAGATACAGACGGGAAGCCATAG -> TAGATACAGACGGGAAGCCATAGT
GCAGTAACGTGACAAGTTGGGTGG -> CAGTAACGTGACAAGTTGGGTGGC
TCACACTGGATCGCATCCGGCCGA -> CACACTGGATCGCATCCGGCCGAA
ATACCCACTGAGAGCGTATGACTG -> TACCCACTGAGAGCGTATGACTGT
GATATTTCGCACTACCACGGGCAA -> ATATTTCGCACTACCACGGGCAAG
GGCGGGAGCCGCATGCGCTACCCA -> GCGGGAGCCGCATGCGCTACCCAT
GGGGAGTCTACCCACTAGTGTTTA -> GGGAGTCTACCCACTAGTGTTTAA
GGCGTACAGAGTCCCCCGCGGCAC -> GCGTACAGAGTCCCCCGCGGCACT
AGTTCGTTTAGTTAGAGGCCAGCT -> GTTCGTTTAGTTAGAGGCCAGCTC
ATTCATGGGGAAAGAGCGCACCAT -> TTCATGGGGAAAGAGCGCACCATT
TGGCCCTTCATTTAGCAAATTCAT -> GGCCCTTCATTTAGCAAATTCATG
CTCCAGAGCATGAATGTATGTTGA -> TCCAGAGCATGAATGTATGTTGAA
CGCCATAAGTCCTTCTAACGACTG -> GCCATAAGTCCTTCTAACGACTGA
CAGACTTGCTCCAGAGCATGAATG -> AGACTTGCTCCAGAGCATGAATGT
AATTCAACTGCCTCGCCAGCACAT -> ATTCAACTGCCTCGCCAGCACATC
CCCCCGGAGGAGCATTTCGCTGTT -> CCCCGGAGGAGCATTTCGCTGTTG
TTGGACTGTTGGCGTTGTACTCGT -> TGGACTGTTGGCGTTGTACTCGTG
GGCGAACTGCAGGAAAATAACCAG -> GCGAACTGCAGGAAAATAACCAGA
AGCCGGACCTTTTGTACAGTTCGT -> GCCGGACCTTTTGTACAGTTCGTT
GCCGTTTTGTAATTTTTATGCAAC -> CCGTTTTGTAATTTTTATGCAACT
ATTATTCATCTACTCCACCGCAGT -> TTATTCATCTACTCCACCGCAGTA
CGAGCAGAACGCTACCAGTAAGGA -> GAGCAGAACGCTACCAGTAAGGAA
ACGGGTATCTAATTACCAGAGCAC -> CGGGTATCTAATTACCAGAGCACA
ACATCTCGCCGTTGGGAGCGATGA -> CATCTCGCCGTTGGGAGCGATGAC
GTTGGGTGGCTGCCGGATCCCCAA -> TTGGGTGGCTGCCGGATCCCCAAC
ACAACAAAGAATGAACGCAGTGCC -> CAACAAAGAATGAACGCAGTGCCC
TTCTAACGACTGAGGTTGGCCCTT -> TCTAACGACTGAGGTTGGCCCTTC
CGAAAGACTTTGGCGTTCCGACTG -> GAAAGACTTTGGCGTTCCGACTGG
CCCCGGAGGAGCATTTCGCTGTTG -> CCCGGAGGAGCATTTCGCTGTTGT
TAAACCCTTATCCGTTCACAAGCC -> AAACCCTTATCCGTTCACAAGCCA
CTACCACACTGACCTACGATATTT -> TACCACACTGACCTACGATATTTC
GTGGAGGACCACTCGTCGTGCGCG -> TGGAGGACCACTCGTCGTGCGCGC
GTTGGGAGCGATGACCTACAGCGC -> TTGGGAGCGATGACCTACAGCGCA
GGGACATAGTTGTACTTCACTAGT -> GGACATAGTTGTACTTCACTAGTG
ACGCAGTGCCCTACCCCCAGGTCC -> CGCAGTGCCCTACCCCCAGGTCCT
TGAGGCAGTAGTGGTATGCTTACC -> GAGGCAGTAGTGGTATGCTTACCG
CTTGACCTGGGCAAACCTACCGAT -> TTGACCTGGGCAAACCTACCGATT
AACTTTGAAGATAATCGTTTCGAT -> ACTTTGAAGATAATCGTTTCGATG
CTATCGCCGTTTTGTAATTTTTAT -> TATCGCCGTTTTGTAATTTTTATG
ACAAGTTGGGTGGCTGCCGGATCC -> CAAGTTGGGTGGCTGCCGGATCCC
TGCCGGATCCCCAACTGATCGGCT -> GCCGGATCCCCAACTGATCGGCTT
TTCAGATGCACTCCCCTCGTACTT -> TCAGATGCACTCCCCTCGTACTTT
GGATTTAGGGCTTTCACTATTAAA -> GATTTAGGGCTTTCACTATTAAAC
TTCGTTTAGTTAGAGGCCAGCTCC -> TCGTTTAGTTAGAGGCCAGCTCCG
CCCCATGCTCGGCGTACAGAGTCC -> CCCATGCTCGGCGTACAGAGTCCC
TTTCTCACTTTTGTGAAGGTCTCG -> TTCTCACTTTTGTGAAGGTCTCGT
ATAGGTCGTCTTGACCTGGGCAAA -> TAGGTCGTCTTGACCTGGGCAAAC
ACGGGATTCCTTGGCTTTGTCTAC -> CGGGATTCCTTGGCTTTGTCTACT
ACTAATAAGCCCTTGTATAAACGG -> CTAATAAGCCCTTGTATAAACGGT
CTCATGGAGGCCCCGCACCTTGCA -> TCATGGAGGCCCCGCACCTTGCAC
CACTGAGAGCGTATGACTGTTTTT -> ACTGAGAGCGTATGACTGTTTTTG
TCGGGCATAAATTCAACTGCCTCG -> CGGGCATAAATTCAACTGCCTCGC
TAAGCTTCAAGTGCGATGCGTGGA -> AAGCTTCAAGTGCGATGCGTGGAT
CAACAGGCGAACTGCAGGAAAATA -> AACAGGCGAACTGCAGGAAAATAA
GATGCCCCTACGCAGGATATTTTC -> ATGCCCCTACGCAGGATATTTTCT
ATACCAGGACAATTTGTGGTCAAC -> TACCAGGACAATTTGTGGTCAACA
TTCACAAGCCACCGTTATTTCGCG -> TCACAAGCCACCGTTATTTCGCGT
ACGTCGTCGGAAGACAGACTTGCT -> CGTCGTCGGAAGACAGACTTGCTC
ACGACTGAGGTTGGCCCTTCATTT -> CGACTGAGGTTGGCCCTTCATTTA
ATAGTTGTACTTCACTAGTGGGAC -> TAGTTGTACTTCACTAGTGGGACT
TCGTCTTGACCTGGGCAAACCTAC -> CGTCTTGACCTGGGCAAACCTACC
TAGAAAATACCAGGACAATTTGTG -> AGAAAATACCAGGACAATTTGTGG
TGACAAGTTGGGTGGCTGCCGGAT -> GACAAGTTGGGTGGCTGCCGGATC
TTCTCAGTGTTGATTGATGCGGCT -> TCTCAGTGTTGATTGATGCGGCTA
AACACCGTTATGACCGCCATAAGT -> ACACCGTTATGACCGCCATAAGTC
TTCACTAGTGGGACTGGTGAGTGA -> TCACTAGTGGGACTGGTGAGTGAA
TAATCGTTTCGATGCCCCTACGCA -> AATCGTTTCGATGCCCCTACGCAG
TCGTCGTGCGCGCGTACGCCACAT -> CGTCGTGCGCGCGTACGCCACATC
TTTTCTACAATTTGGAGTCATGAG -> TTTCTACAATTTGGAGTCATGAGC
AGTGTTCGCCTGCCCGAGCAGAAC -> GTGTTCGCCTGCCCGAGCAGAACG
CCGGCTCGATGCTCGTCCTCATGG -> CGGCTCGATGCTCGTCCTCATGGA
CCCCCAGGTCCTTCTAAGCGTTCC -> CCCCAGGTCCTTCTAAGCGTTCCA
TTCGCACTACCACGGGCAAGTTAC -> TCGCACTACCACGGGCAAGTTACA
GAGCAGAACGCTACCAGTAAGGAA -> AGCAGAACGCTACCAGTAAGGAAC
TCCCAACTTTGAAGATAATCGTTT -> CCCAACTTTGAAGATAATCGTTTC
CTGGAGCCGTGGAGGAAAATACGG -> TGGAGCCGTGGAGGAAAATACGGC
ACAAGCCACCGTTATTTCGCGTTT -> CAAGCCACCGTTATTTCGCGTTTC
GTCTCACACTGGATCGCATCCGGC -> TCTCACACTGGATCGCATCCGGCC
CACGGGCAAGTTACATTGGTGTCA -> ACGGGCAAGTTACATTGGTGTCAT
CTTAGGTGTATAAAAGTCAGAGGA -> TTAGGTGTATAAAAGTCAGAGGAG
TGACCTGGGCAAACCTACCGATTC -> GACCTGGGCAAACCTACCGATTCT
GCTGGATGACGCGTATACGGGTAT -> CTGGATGACGCGTATACGGGTATC
GGCTTCCAGCTTGAGGATTTAGGG -> GCTTCCAGCTTGAGGATTTAGGGC
ATTCAACGGGAACAACCAGGGCGG -> TTCAACGGGAACAACCAGGGCGGC
GGGTGGCTGCCGGATCCCCAACTG -> GGTGGCTGCCGGATCCCCAACTGA
CATGCGCTACCCATAATACACTGA -> ATGCGCTACCCATAATACACTGAT
AGCCGTGGAGGAAAATACGGCACT -> GCCGTGGAGGAAAATACGGCACTT
ATAAATTTACCTTCACCTTAAGCC -> TAAATTTACCTTCACCTTAAGCCC
GATCGGCCTTTATAAATTTACCTT -> ATCGGCCTTTATAAATTTACCTTC
AGTTGGGTGGCTGCCGGATCCCCA -> GTTGGGTGGCTGCCGGATCCCCAA
GAGGCTTCCAGCTTGAGGATTTAG -> AGGCTTCCAGCTTGAGGATTTAGG
AACGCAGTGCCCTACCCCCAGGTC -> ACGCAGTGCCCTACCCCCAGGTCC
TACGCCACATCCTGTTCACCGCTT -> ACGCCACATCCTGTTCACCGCTTA
TTTAGGGCTTTCACTATTAAACCC -> TTAGGGCTTTCACTATTAAACCCT
ATTAGAGAAGCCCTATCGCCGTTT -> TTAGAGAAGCCCTATCGCCGTTTT
ATAGTCGGCGGGAGCCGCATGCGC -> TAGTCGGCGGGAGCCGCATGCGCT
TGACCCCCGGAGGAGCATTTCGCT -> GACCCCCGGAGGAGCATTTCGCTG
ATTTCGCGTTTCTCAGTGTTGATT -> TTTCGCGTTTCTCAGTGTTGATTG
ACGATCTGGTCTTCTGGTGGACGC -> CGATCTGGTCTTCTGGTGGACGCT
TCCAGCTTGAGGATTTAGGGCTTT -> CCAGCTTGAGGATTTAGGGCTTTC
GCCCCTACGCAGGATATTTTCTAC -> CCCCTACGCAGGATATTTTCTACA
CGTAGAAAATACCAGGACAATTTG -> GTAGAAAATACCAGGACAATTTGT
AACAGTGGCGGCCTCTTTAGAGTT -> ACAGTGGCGGCCTCTTTAGAGTTG
CCGGCCGAAGTGTATGTCTAGAGG -> CGGCCGAAGTGTATGTCTAGAGGG
CGTGCAGTCCTTTCAGGACGCGTC -> GTGCAGTCCTTTCAGGACGCGTCG
AATGTATGTTGAACCGGACATCTA -> ATGTATGTTGAACCGGACATCTAC
ACAATTTGGAGTCATGAGCCGGAC -> CAATTTGGAGTCATGAGCCGGACC
AATGAACGCAGTGCCCTACCCCCA -> ATGAACGCAGTGCCCTACCCCCAG
TAAGGAACACCGTTATGACCGCCA -> AAGGAACACCGTTATGACCGCCAT
CTACCCCCAGGTCCTTCTAAGCGT -> TACCCCCAGGTCCTTCTAAGCGTT
CTTTTGTACAGTTCGTTTAGTTAG -> TTTTGTACAGTTCGTTTAGTTAGA
CCCTGTCTTACTTAAGCTTCAAGT -> CCTGTCTTACTTAAGCTTCAAGTG
TTCAACTGCCTCGCCAGCACATCA -> TCAACTGCCTCGCCAGCACATCAT
CCGTTGGGAGCGATGACCTACAGC -> CGTTGGGAGCGATGACCTACAGCG
TCAGGACGCGTCGGAAGGTACGTA -> CAGGACGCGTCGGAAGGTACGTAG
ACAGACTTGCTCCAGAGCATGAAT -> CAGACTTGCTCCAGAGCATGAATG
ACTTTGAAGATAATCGTTTCGATG -> CTTTGAAGATAATCGTTTCGATGC
GACAGGTAGTTGGACTGTTGGCGT -> ACAGGTAGTTGGACTGTTGGCGTT
CAGTCCTTTCAGGACGCGTCGGAA -> AGTCCTTTCAGGACGCGTCGGAAG
GGAAGACAGACTTGCTCCAGAGCA -> GAAGACAGACTTGCTCCAGAGCAT
CATCGAAAGACTTTGGCGTTCCGA -> ATCGAAAGACTTTGGCGTTCCGAC
TAAAAGTCAGAGGAGCTGAGCGTC -> AAAAGTCAGAGGAGCTGAGCGTCG
AAGACAGACTTGCTCCAGAGCATG -> AGACAGACTTGCTCCAGAGCATGA
CTAAATAGCGAACTAATAAGCCCT -> TAAATAGCGAACTAATAAGCCCTT
GACTGGTGAGTGAATCGTCCGGCC -> ACTGGTGAGTGAATCGTCCGGCCG
ATCTGGTCTTCTGGTGGACGCTCC -> TCTGGTCTTCTGGTGGACGCTCCT
GGCGTTCCGACTGGCTGGAGCCGT -> GCGTTCCGACTGGCTGGAGCCGTG
TTAGGTGTATAAAAGTCAGAGGAG -> TAGGTGTATAAAAGTCAGAGGAGC
TCCTTCTAACGACTGAGGTTGGCC -> CCTTCTAACGACTGAGGTTGGCCC
GCCTAGTGTTCGCCTGCCCGAGCA -> CCTAGTGTTCGCCTGCCCGAGCAG
AAGATAATCGTTTCGATGCCCCTA -> AGATAATCGTTTCGATGCCCCTAC
GTCCGATAACACAAACAGTGGCGG -> TCCGATAACACAAACAGTGGCGGC
TAGTGTTCGCCTGCCCGAGCAGAA -> AGTGTTCGCCTGCCCGAGCAGAAC
AGCGATGACCTACAGCGCAGTAAC -> GCGATGACCTACAGCGCAGTAACG
TGTCTTACTTAAGCTTCAAGTGCG -> GTCTTACTTAAGCTTCAAGTGCGA
CTCGTGCAGTCCTTTCAGGACGCG -> TCGTGCAGTCCTTTCAGGACGCGT
GTATCTAATTACCAGAGCACAAGC -> TATCTAATTACCAGAGCACAAGCC
GGAGGAAAATACGGCACTTGGGAA -> GAGGAAAATACGGCACTTGGGAAG
GCGTTCCATGGGTCCCGTCGGGCA -> CGTTCCATGGGTCCCGTCGGGCAT
ACCGCTTAGGTGTATAAAAGTCAG -> CCGCTTAGGTGTATAAAAGTCAGA
ATCGTTTCGATGCCCCTACGCAGG -> TCGTTTCGATGCCCCTACGCAGGA
GGAAGTCCCAACTTTGAAGATAAT -> GAAGTCCCAACTTTGAAGATAATC
GAGGATTTAGGGCTTTCACTATTA -> AGGATTTAGGGCTTTCACTATTAA
AGTAAGGAACACCGTTATGACCGC -> GTAAGGAACACCGTTATGACCGCC
CAGTAAGGAACACCGTTATGACCG -> AGTAAGGAACACCGTTATGACCGC
ACCTACGATATTTCGCACTACCAC -> CCTACGATATTTCGCACTACCACG
TATTTCGCACTACCACGGGCAAGT -> ATTTCGCACTACCACGGGCAAGTT
CAACTATAGTGCGCCGACGTAATG -> AACTATAGTGCGCCGACGTAATGC
AGTGCGCCGACGTAATGCCTGCTG -> GTGCGCCGACGTAATGCCTGCTGG
CCGGGCCCAAAAGGTAATGGTTCA -> CGGGCCCAAAAGGTAATGGTTCAG
CTTTATAAATTTACCTTCACCTTA -> TTTATAAATTTACCTTCACCTTAA
CCGACTGGCTGGAGCCGTGGAGGA -> CGACTGGCTGGAGCCGTGGAGGAA
GCGTATGACTGTTTTTGCCGCATG -> CGTATGACTGTTTTTGCCGCATGC
TTCAACGGGAACAACCAGGGCGGC -> TCAACGGGAACAACCAGGGCGGCA
GGCCGCGTGCACGATACCCACTGA -> GCCGCGTGCACGATACCCACTGAG
AGCCATAGTCGGCGGGAGCCGCAT -> GCCATAGTCGGCGGGAGCCGCATG
CGGCTACATGGAACGGGATTCCTT -> GGCTACATGGAACGGGATTCCTTG
CTACGCAGGATATTTTCTACAATT -> TACGCAGGATATTTTCTACAATTT
CGATCTGGTCTTCTGGTGGACGCT -> GATCTGGTCTTCTGGTGGACGCTC
TCGTCCTCATGGAGGCCCCGCACC -> CGTCCTCATGGAGGCCCCGCACCT
GTTGGCCCTTCATTTAGCAAATTC -> TTGGCCCTTCATTTAGCAAATTCA
CATGGGGAAAGAGCGCACCATTAG -> ATGGGGAAAGAGCGCACCATTAGA
CAGTAGTGGTATGCTTACCGCCGG -> AGTAGTGGTATGCTTACCGCCGGC
AAGAATGAACGCAGTGCCCTACCC -> AGAATGAACGCAGTGCCCTACCCC
TTTGAAGATAATCGTTTCGATGCC -> TTGAAGATAATCGTTTCGATGCCC
CCGCGGCCGGGCCCAAAAGGTAAT -> CGCGGCCGGGCCCAAAAGGTAATG
TCCTCCGTGGAGGACCACTCGTCG -> CCTCCGTGGAGGACCACTCGTCGT
TCTGGTGGACGCTCCTCCGTGGAG -> CTGGTGGACGCTCCTCCGTGGAGG
ATTTTCTACAATTTGGAGTCATGA -> TTTTCTACAATTTGGAGTCATGAG
ATGATGAGCTAAATAGCGAACTAA -> TGATGAGCTAAATAGCGAACTAAT
ACTTCACTAGTGGGACTGGTGAGT -> CTTCACTAGTGGGACTGGTGAGTG
CGGCTTCACCGCTGCCCCCCCCAT -> GGCTTCACCGCTGCCCCCCCCATG
CTACAATTTGGAGTCATGAGCCGG -> TACAATTTGGAGTCATGAGCCGGA
CCCGCGGCACTGAGGCAGTAGTGG -> CCGCGGCACTGAGGCAGTAGTGGT
TACACGATCTGGTCTTCTGGTGGA -> ACACGATCTGGTCTTCTGGTGGAC
GTAGAGGCTTCCAGCTTGAGGATT -> TAGAGGCTTCCAGCTTGAGGATTT
AGCGCAGTAACGTGACAAGTTGGG -> GCGCAGTAACGTGACAAGTTGGGT
ACTGATCGGCTTCACCGCTGCCCC -> CTGATCGGCTTCACCGCTGCCCCC
GCTAAATAGCGAACTAATAAGCCC -> CTAAATAGCGAACTAATAAGCCCT
GAACTGCAGGAAAATAACCAGATG -> AACTGCAGGAAAATAACCAGATGA
CTTTTGTGAAGGTCTCGTCTCACA -> TTTTGTGAAGGTCTCGTCTCACAC
CCGAGCAGAACGCTACCAGTAAGG -> CGAGCAGAACGCTACCAGTAAGGA
TCTCAGTGTTGATTGATGCGGCTA -> CTCAGTGTTGATTGATGCGGCTAC
GTTGGCGTTGTACTCGTGCAGTCC -> TTGGCGTTGTACTCGTGCAGTCCT
GGAACGGGATTCCTTGGCTTTGTC -> GAACGGGATTCCTTGGCTTTGTCT
TGAAGATAATCGTTTCGATGCCCC -> GAAGATAATCGTTTCGATGCCCCT
AAGTCCTTCTAACGACTGAGGTTG -> AGTCCTTCTAACGACTGAGGTTGG
CGCCGTTGGGAGCGATGACCTACA -> GCCGTTGGGAGCGATGACCTACAG
CAACTGATCGGCTTCACCGCTGCC -> AACTGATCGGCTTCACCGCTGCCC
AGTTAGAGGCCAGCTCCGCGGCCG -> GTTAGAGGCCAGCTCCGCGGCCGG
CATTAGAGAAGCCCTATCGCCGTT -> ATTAGAGAAGCCCTATCGCCGTTT
GGTTCAGATGCACTCCCCTCGTAC -> GTTCAGATGCACTCCCCTCGTACT
CTACTCCACCGCAGTACGTGCATA -> TACTCCACCGCAGTACGTGCATAG
CGAAGTGTATGTCTAGAGGGGGGA -> GAAGTGTATGTCTAGAGGGGGGAG
CGATTCTGTTAAGGCGTCATCCTG -> GATTCTGTTAAGGCGTCATCCTGT
TGAATGTATGTTGAACCGGACATC -> GAATGTATGTTGAACCGGACATCT
AGGACAATTTGTGGTCAACAGGCG -> GGACAATTTGTGGTCAACAGGCGA
AACTATAGTGCGCCGACGTAATGC -> ACTATAGTGCGCCGACGTAATGCC
GACGCGTATACGGGTATCTAATTA -> ACGCGTATACGGGTATCTAATTAC
AGGAGATGTTGCCTAAACGTCGTC -> GGAGATGTTGCCTAAACGTCGTCG
GGAGGAGCATTTCGCTGTTGTCCG -> GAGGAGCATTTCGCTGTTGTCCGA
GAGGACCACTCGTCGTGCGCGCGT -> AGGACCACTCGTCGTGCGCGCGTA
GAACTAATAAGCCCTTGTATAAAC -> AACTAATAAGCCCTTGTATAAACG
GGGAGTCTACCCACTAGTGTTTAA -> GGAGTCTACCCACTAGTGTTTAAT
AAGGCGTCATCCTGTAGGTCGAAT -> AGGCGTCATCCTGTAGGTCGAATG
ACATGGAACGGGATTCCTTGGCTT -> CATGGAACGGGATTCCTTGGCTTT
ATGCAACTATAGTGCGCCGACGTA -> TGCAACTATAGTGCGCCGACGTAA
AATGGTTCAGATGCACTCCCCTCG -> ATGGTTCAGATGCACTCCCCTCGT
AGCACATCATATGTGTCGTGAAGA -> GCACATCATATGTGTCGTGAAGAG
CCCAACTGATCGGCTTCACCGCTG -> CCAACTGATCGGCTTCACCGCTGC
GAAGATAATCGTTTCGATGCCCCT -> AAGATAATCGTTTCGATGCCCCTA
CTGTAGGTCGAATGAGGGGCTAGT -> TGTAGGTCGAATGAGGGGCTAGTC
ATGGAGGCCCCGCACCTTGCACAC -> TGGAGGCCCCGCACCTTGCACACA
TTGGCGTTGTACTCGTGCAGTCCT -> TGGCGTTGTACTCGTGCAGTCCTT
ACCCACTGAGAGCGTATGACTGTT -> CCCACTGAGAGCGTATGACTGTTT
GGCTAGTCAGGGACATAGTTGTAC -> GCTAGTCAGGGACATAGTTGTACT
AGGGCTTTCACTATTAAACCCTTA -> GGGCTTTCACTATTAAACCCTTAT
CAAGCCACCGTTATTTCGCGTTTC -> AAGCCACCGTTATTTCGCGTTTCT
GTTCCATGGGTCCCGTCGGGCATA -> TTCCATGGGTCCCGTCGGGCATAA
GGAAAATACGGCACTTGGGAAGTC -> GAAAATACGGCACTTGGGAAGTCC
TGCCCGAGCAGAACGCTACCAGTA -> GCCCGAGCAGAACGCTACCAGTAA
TCATGCCATCTATATAGTCAAATT -> CATGCCATCTATATAGTCAAATTT
GGTTGGCCCTTCATTTAGCAAATT -> GTTGGCCCTTCATTTAGCAAATTC
TCAGTGTTGATTGATGCGGCTACA -> CAGTGTTGATTGATGCGGCTACAT
ACAGTGGCGGCCTCTTTAGAGTTG -> CAGTGGCGGCCTCTTTAGAGTTGG
TGAGACAACAAAGAATGAACGCAG -> GAGACAACAAAGAATGAACGCAGT
CCAGAGCATGAATGTATGTTGAAC -> CAGAGCATGAATGTATGTTGAACC
ACGATCGGCCTTTATAAATTTACC -> CGATCGGCCTTTATAAATTTACCT
CCCAGGTCCTTCTAAGCGTTCCAT -> CCAGGTCCTTCTAAGCGTTCCATG
TAGTGGTATGCTTACCGCCGGCTC -> AGTGGTATGCTTACCGCCGGCTCG
GGACCACTCGTCGTGCGCGCGTAC -> GACCACTCGTCGTGCGCGCGTACG
TGCCCCTACGCAGGATATTTTCTA -> GCCCCTACGCAGGATATTTTCTAC
TGCACGATACCCACTGAGAGCGTA -> GCACGATACCCACTGAGAGCGTAT
ATCTCTGAGCCCGCCGTAGAGGCT -> TCTCTGAGCCCGCCGTAGAGGCTT
ACAAGCCGACGATCGGCCTTTATA -> CAAGCCGACGATCGGCCTTTATAA
GTGGAGGAAAATACGGCACTTGGG -> TGGAGGAAAATACGGCACTTGGGA
AACATCTCGCCGTTGGGAGCGATG -> ACATCTCGCCGTTGGGAGCGATGA
TGAGTGAATCGTCCGGCCGCGTGC -> GAGTGAATCGTCCGGCCGCGTGCA
CTGATCGGCTTCACCGCTGCCCCC -> TGATCGGCTTCACCGCTGCCCCCC
CAAAGAATGAACGCAGTGCCCTAC -> AAAGAATGAACGCAGTGCCCTACC
TGTTTTTGCCGCATGCGACAGCAA -> GTTTTTGCCGCATGCGACAGCAAT
TCTCGCCGTTGGGAGCGATGACCT -> CTCGCCGTTGGGAGCGATGACCTA
CTAACGACTGAGGTTGGCCCTTCA -> TAACGACTGAGGTTGGCCCTTCAT
CTAGAGGGGGGAGTCTACCCACTA -> TAGAGGGGGGAGTCTACCCACTAG
AGCTAAATAGCGAACTAATAAGCC -> GCTAAATAGCGAACTAATAAGCCC
ACTTTGGCGTTCCGACTGGCTGGA -> CTTTGGCGTTCCGACTGGCTGGAG
ACACTAGGGCTACCCGTATCTCTG -> CACTAGGGCTACCCGTATCTCTGA
CCATGCTCGGCGTACAGAGTCCCC -> CATGCTCGGCGTACAGAGTCCCCC
AGGAAAATAACCAGATGAGACAAC -> GGAAAATAACCAGATGAGACAACA
AGCAGAACGCTACCAGTAAGGAAC -> GCAGAACGCTACCAGTAAGGAACA
ACCTTGCACACACTAGGGCTACCC -> CCTTGCACACACTAGGGCTACCCG
ATTCCGAAGACAGGTAGTTGGACT -> TTCCGAAGACAGGTAGTTGGACTG
GGAAAGAGCGCACCATTAGAGAAG -> GAAAGAGCGCACCATTAGAGAAGC
ACTAGTGTTTAATAACCATTTTAT -> CTAGTGTTTAATAACCATTTTATG
GGCTCGATGCTCGTCCTCATGGAG -> GCTCGATGCTCGTCCTCATGGAGG
CACCGCAGTACGTGCATAGGTCGT -> ACCGCAGTACGTGCATAGGTCGTC
GAGACAACAAAGAATGAACGCAGT -> AGACAACAAAGAATGAACGCAGTG
TTTGTACAGTTCGTTTAGTTAGAG -> TTGTACAGTTCGTTTAGTTAGAGG
AGGTCGTCTTGACCTGGGCAAACC -> GGTCGTCTTGACCTGGGCAAACCT
TGTTGAACCGGACATCTACAACAT -> GTTGAACCGGACATCTACAACATC
CTCTTTAGAGTTGGCCACCCAGGA -> TCTTTAGAGTTGGCCACCCAGGAT
ACCCACTAGTGTTTAATAACCATT -> CCCACTAGTGTTTAATAACCATTT
ACGGGAAGCCATAGTCGGCGGGAG -> CGGGAAGCCATAGTCGGCGGGAGC
TAATGCCTGCTGGATGACGCGTAT -> AATGCCTGCTGGATGACGCGTATA
TAATTCCGAAGACAGGTAGTTGGA -> AATTCCGAAGACAGGTAGTTGGAC
CGATATTTCGCACTACCACGGGCA -> GATATTTCGCACTACCACGGGCAA
GCGCGCGTACGCCACATCCTGTTC -> CGCGCGTACGCCACATCCTGTTCA
AGCGTATGACTGTTTTTGCCGCAT -> GCGTATGACTGTTTTTGCCGCATG
TCTACTAGCCAAAGTTCGCTTTTT -> CTACTAGCCAAAGTTCGCTTTTTG
ACTGTTGGCGTTGTACTCGTGCAG -> CTGTTGGCGTTGTACTCGTGCAGT
CGTATCTCTGAGCCCGCCGTAGAG -> GTATCTCTGAGCCCGCCGTAGAGG
CTGTTTTTGCCGCATGCGACAGCA -> TGTTTTTGCCGCATGCGACAGCAA
GTGTTTAATAACCATTTTATGTTG -> TGTTTAATAACCATTTTATGTTGT
ACCAGGACAATTTGTGGTCAACAG -> CCAGGACAATTTGTGGTCAACAGG
GACCTGGGCAAACCTACCGATTCT -> ACCTGGGCAAACCTACCGATTCTG
TTATGACCGCCATAAGTCCTTCTA -> TATGACCGCCATAAGTCCTTCTAA
GGACGCGTCGGAAGGTACGTAGAA -> GACGCGTCGGAAGGTACGTAGAAA
TAGCCAAAGTTCGCTTTTTGAGAG -> AGCCAAAGTTCGCTTTTTGAGAGG
ATGCCCCTACGCAGGATATTTTCT -> TGCCCCTACGCAGGATATTTTCTA
TGTAGGTCGAATGAGGGGCTAGTC -> GTAGGTCGAATGAGGGGCTAGTCA
ACGGCACTTGGGAAGTCCCAACTT -> CGGCACTTGGGAAGTCCCAACTTT
CCTACCGATTCTGTTAAGGCGTCA -> CTACCGATTCTGTTAAGGCGTCAT
CGTCGGGCATAAATTCAACTGCCT -> GTCGGGCATAAATTCAACTGCCTC
CTCGATGCTCGTCCTCATGGAGGC -> TCGATGCTCGTCCTCATGGAGGCC
GGTATGCTTACCGCCGGCTCGATG -> GTATGCTTACCGCCGGCTCGATGC
TGATTGATGCGGCTACATGGAACG -> GATTGATGCGGCTACATGGAACGG
CATCTACTCCACCGCAGTACGTGC -> ATCTACTCCACCGCAGTACGTGCA
ACATCTACAACATCTCGCCGTTGG -> CATCTACAACATCTCGCCGTTGGG
AGTGTTTAATAACCATTTTATGTT -> GTGTTTAATAACCATTTTATGTTG
TCTAGAGGGGGGAGTCTACCCACT -> CTAGAGGGGGGAGTCTACCCACTA
TTTTGTGAAGGTCTCGTCTCACAC -> TTTGTGAAGGTCTCGTCTCACACT
CAGGATTGGCGCATACACGATCTG -> AGGATTGGCGCATACACGATCTGG
GTAACGTGACAAGTTGGGTGGCTG -> TAACGTGACAAGTTGGGTGGCTGC
GTAGAAAATACCAGGACAATTTGT -> TAGAAAATACCAGGACAATTTGTG
GTGTCATCGAAAGACTTTGGCGTT -> TGTCATCGAAAGACTTTGGCGTTC
TCCGGCCGAAGTGTATGTCTAGAG -> CCGGCCGAAGTGTATGTCTAGAGG
GTCATCGAAAGACTTTGGCGTTCC -> TCATCGAAAGACTTTGGCGTTCCG
GGCGGCCTCTTTAGAGTTGGCCAC -> GCGGCCTCTTTAGAGTTGGCCACC
GGCCCTTCATTTAGCAAATTCATG -> GCCCTTCATTTAGCAAATTCATGG
AAACCCTTATCCGTTCACAAGCCA -> AACCCTTATCCGTTCACAAGCCAC
AGCCCGCCGTAGAGGCTTCCAGCT -> GCCCGCCGTAGAGGCTTCCAGCTT
GTATGACTGTTTTTGCCGCATGCG -> TATGACTGTTTTTGCCGCATGCGA
CGCTGTTGTCCGATAACACAAACA -> GCTGTTGTCCGATAACACAAACAG
CTAGGGCTACCCGTATCTCTGAGC -> TAGGGCTACCCGTATCTCTGAGCC
TATAGTCAAATTTTCTCACTTTTG -> ATAGTCAAATTTTCTCACTTTTGT
CCGTTATGACCGCCATAAGTCCTT -> CGTTATGACCGCCATAAGTCCTTC
ATGTGTCGTGAAGAGGAGATGTTG -> TGTGTCGTGAAGAGGAGATGTTGC
TAGTGGGACTGGTGAGTGAATCGT -> AGTGGGACTGGTGAGTGAATCGTC
TGCGCGCGTACGCCACATCCTGTT -> GCGCGCGTACGCCACATCCTGTTC
CATCTATATAGTCAAATTTTCTCA -> ATCTATATAGTCAAATTTTCTCAC
CGCAGTAACGTGACAAGTTGGGTG -> GCAGTAACGTGACAAGTTGGGTGG
AGGCCAGCTCCGCGGCCGGGCCCA -> GGCCAGCTCCGCGGCCGGGCCCAA
GCAGTGCCCTACCCCCAGGTCCTT -> CAGTGCCCTACCCCCAGGTCCTTC
CGGGCATAAATTCAACTGCCTCGC -> GGGCATAAATTCAACTGCCTCGCC
GGCCCCGCACCTTGCACACACTAG -> GCCCCGCACCTTGCACACACTAGG
CGGCACTTGGGAAGTCCCAACTTT -> GGCACTTGGGAAGTCCCAACTTTG
CACTATTAAACCCTTATCCGTTCA -> ACTATTAAACCCTTATCCGTTCAC
ACAGGCGAACTGCAGGAAAATAAC -> CAGGCGAACTGCAGGAAAATAACC
GCCTGCCCGAGCAGAACGCTACCA -> CCTGCCCGAGCAGAACGCTACCAG
CCCGCCGTAGAGGCTTCCAGCTTG -> CCGCCGTAGAGGCTTCCAGCTTGA
ACCAGATGAGACAACAAAGAATGA -> CCAGATGAGACAACAAAGAATGAA
TCAGGGACATAGTTGTACTTCACT -> CAGGGACATAGTTGTACTTCACTA
ATGACCGCCATAAGTCCTTCTAAC -> TGACCGCCATAAGTCCTTCTAACG
GGTAGATACAGACGGGAAGCCATA -> GTAGATACAGACGGGAAGCCATAG
TATGACTGTTTTTGCCGCATGCGA -> ATGACTGTTTTTGCCGCATGCGAC
ATAAGTCCTTCTAACGACTGAGGT -> TAAGTCCTTCTAACGACTGAGGTT
AAGAGGAGATGTTGCCTAAACGTC -> AGAGGAGATGTTGCCTAAACGTCG
CAATTTGTGGTCAACAGGCGAACT -> AATTTGTGGTCAACAGGCGAACTG
CCCTTATCCGTTCACAAGCCACCG -> CCTTATCCGTTCACAAGCCACCGT
TGCAGTCCTTTCAGGACGCGTCGG -> GCAGTCCTTTCAGGACGCGTCGGA
GCATGCGCTACCCATAATACACTG -> CATGCGCTACCCATAATACACTGA
AGAGTTGGCCACCCAGGATTGGCG -> GAGTTGGCCACCCAGGATTGGCGC
TACAGAGTCCCCCGCGGCACTGAG -> ACAGAGTCCCCCGCGGCACTGAGG
CTCGTCTCACACTGGATCGCATCC -> TCGTCTCACACTGGATCGCATCCG
ATATAGTCAAATTTTCTCACTTTT -> TATAGTCAAATTTTCTCACTTTTG
TTTCTACAATTTGGAGTCATGAGC -> TTCTACAATTTGGAGTCATGAGCC
CCATTAGAGAAGCCCTATCGCCGT -> CATTAGAGAAGCCCTATCGCCGTT
AGCCGCATGCGCTACCCATAATAC -> GCCGCATGCGCTACCCATAATACA
GTGTATAAAAGTCAGAGGAGCTGA -> TGTATAAAAGTCAGAGGAGCTGAG
GCTTCCAGCTTGAGGATTTAGGGC -> CTTCCAGCTTGAGGATTTAGGGCT
ATAAACGGTGACCCCCGGAGGAGC -> TAAACGGTGACCCCCGGAGGAGCA
GCTCCAGAGCATGAATGTATGTTG -> CTCCAGAGCATGAATGTATGTTGA
ACTAGGGCTACCCGTATCTCTGAG -> CTAGGGCTACCCGTATCTCTGAGC
TATAGTGCGCCGACGTAATGCCTG -> ATAGTGCGCCGACGTAATGCCTGC
TTTGTGAAGGTCTCGTCTCACACT -> TTGTGAAGGTCTCGTCTCACACTG
ACAAAGAATGAACGCAGTGCCCTA -> CAAAGAATGAACGCAGTGCCCTAC
CACACTGGATCGCATCCGGCCGAA -> ACACTGGATCGCATCCGGCCGAAG
GTCTACCCACTAGTGTTTAATAAC -> TCTACCCACTAGTGTTTAATAACC
TTTTATGTTGTAATTCAACGGGAA -> TTTATGTTGTAATTCAACGGGAAC
AGATAATCGTTTCGATGCCCCTAC -> GATAATCGTTTCGATGCCCCTACG
CAAACCTACCGATTCTGTTAAGGC -> AAACCTACCGATTCTGTTAAGGCG
TATGCAACTATAGTGCGCCGACGT -> ATGCAACTATAGTGCGCCGACGTA
AAGCCGACGATCGGCCTTTATAAA -> AGCCGACGATCGGCCTTTATAAAT
CGCCAGCACATCATATGTGTCGTG -> GCCAGCACATCATATGTGTCGTGA
CATCCTGTTCACCGCTTAGGTGTA -> ATCCTGTTCACCGCTTAGGTGTAT
CCTACAGCGCAGTAACGTGACAAG -> CTACAGCGCAGTAACGTGACAAGT
AATCGTTTCGATGCCCCTACGCAG -> ATCGTTTCGATGCCCCTACGCAGG
AGACAACAAAGAATGAACGCAGTG -> GACAACAAAGAATGAACGCAGTGC
CGCACCATTAGAGAAGCCCTATCG -> GCACCATTAGAGAAGCCCTATCGC
GGTCGTCTTGACCTGGGCAAACCT -> GTCGTCTTGACCTGGGCAAACCTA
GGGAAGCCATAGTCGGCGGGAGCC -> GGAAGCCATAGTCGGCGGGAGCCG
TGTCTAGAGGGGGGAGTCTACCCA -> GTCTAGAGGGGGGAGTCTACCCAC
CAGATGCACTCCCCTCGTACTTTG -> AGATGCACTCCCCTCGTACTTTGG
AACAGGCGAACTGCAGGAAAATAA -> ACAGGCGAACTGCAGGAAAATAAC
TCACTTTTGTGAAGGTCTCGTCTC -> CACTTTTGTGAAGGTCTCGTCTCA
GCAGGATATTTTCTACAATTTGGA -> CAGGATATTTTCTACAATTTGGAG
TGGACGCTCCTCCGTGGAGGACCA -> GGACGCTCCTCCGTGGAGGACCAC
TCGGCGGGAGCCGCATGCGCTACC -> CGGCGGGAGCCGCATGCGCTACCC
CCATGGGTCCCGTCGGGCATAAAT -> CATGGGTCCCGTCGGGCATAAATT
GCAGGAAAATAACCAGATGAGACA -> CAGGAAAATAACCAGATGAGACAA
TCGGCGTACAGAGTCCCCCGCGGC -> CGGCGTACAGAGTCCCCCGCGGCA
AGTTGTACTTCACTAGTGGGACTG -> GTTGTACTTCACTAGTGGGACTGG
TTCTCACTTTTGTGAAGGTCTCGT -> TCTCACTTTTGTGAAGGTCTCGTC
TTTCGCGTTTCTCAGTGTTGATTG -> TTCGCGTTTCTCAGTGTTGATTGA
CGTCGGAAGGTACGTAGAAAATAC -> GTCGGAAGGTACGTAGAAAATACC
CCTTTCAGGACGCGTCGGAAGGTA -> CTTTCAGGACGCGTCGGAAGGTAC
AGCCCTTGTATAAACGGTGACCCC -> GCCCTTGTATAAACGGTGACCCCC
CCCCAGGTCCTTCTAAGCGTTCCA -> CCCAGGTCCTTCTAAGCGTTCCAT
ATGAATGTATGTTGAACCGGACAT -> TGAATGTATGTTGAACCGGACATC
GACCTACGATATTTCGCACTACCA -> ACCTACGATATTTCGCACTACCAC
AGGACGCGTCGGAAGGTACGTAGA -> GGACGCGTCGGAAGGTACGTAGAA
GGTGACCCCCGGAGGAGCATTTCG -> GTGACCCCCGGAGGAGCATTTCGC
TAGGTGTATAAAAGTCAGAGGAGC -> AGGTGTATAAAAGTCAGAGGAGCT
ATGCGGCTACATGGAACGGGATTC -> TGCGGCTACATGGAACGGGATTCC
ACACCGTTATGACCGCCATAAGTC -> CACCGTTATGACCGCCATAAGTCC
ACGCTACCAGTAAGGAACACCGTT -> CGCTACCAGTAAGGAACACCGTTA
CTGGATCGCATCCGGCCGAAGTGT -> TGGATCGCATCCGGCCGAAGTGTA
TGCCCTACCCCCAGGTCCTTCTAA -> GCCCTACCCCCAGGTCCTTCTAAG
CATGCTCGGCGTACAGAGTCCCCC -> ATGCTCGGCGTACAGAGTCCCCCG
TGCGCTACCCATAATACACTGATT -> GCGCTACCCATAATACACTGATTT
CGGAGGAGCATTTCGCTGTTGTCC -> GGAGGAGCATTTCGCTGTTGTCCG
TCTACAACATCTCGCCGTTGGGAG -> CTACAACATCTCGCCGTTGGGAGC
TGCAGGAAAATAACCAGATGAGAC -> GCAGGAAAATAACCAGATGAGACA
GCTGGAGCCGTGGAGGAAAATACG -> CTGGAGCCGTGGAGGAAAATACGG
TGTTAAGGCGTCATCCTGTAGGTC -> GTTAAGGCGTCATCCTGTAGGTCG
GAGCGTATGACTGTTTTTGCCGCA -> AGCGTATGACTGTTTTTGCCGCAT
AATTTGGAGTCATGAGCCGGACCT -> ATTTGGAGTCATGAGCCGGACCTT
TCTGTTAAGGCGTCATCCTGTAGG -> CTGTTAAGGCGTCATCCTGTAGGT
TTCATGGGGAAAGAGCGCACCATT -> TCATGGGGAAAGAGCGCACCATTA
AATAACCAGATGAGACAACAAAGA -> ATAACCAGATGAGACAACAAAGAA
TAAGGCGTCATCCTGTAGGTCGAA -> AAGGCGTCATCCTGTAGGTCGAAT
AATTACCAGAGCACAAGCCGACGA -> ATTACCAGAGCACAAGCCGACGAT
GGCGTCATCCTGTAGGTCGAATGA -> GCGTCATCCTGTAGGTCGAATGAG
AACGGTGACCCCCGGAGGAGCATT -> ACGGTGACCCCCGGAGGAGCATTT
AGTCCCCCGCGGCACTGAGGCAGT -> GTCCCCCGCGGCACTGAGGCAGTA
ATCTAATTACCAGAGCACAAGCCG -> TCTAATTACCAGAGCACAAGCCGA
TTGCACACACTAGGGCTACCCGTA -> TGCACACACTAGGGCTACCCGTAT
CATAAATTCAACTGCCTCGCCAGC -> ATAAATTCAACTGCCTCGCCAGCA
GGGTCCCGTCGGGCATAAATTCAA -> GGTCCCGTCGGGCATAAATTCAAC
AGGATATTTTCTACAATTTGGAGT -> GGATATTTTCTACAATTTGGAGTC
GGTGTCATCGAAAGACTTTGGCGT -> GTGTCATCGAAAGACTTTGGCGTT
CCAGGATTGGCGCATACACGATCT -> CAGGATTGGCGCATACACGATCTG
TTTATAAATTTACCTTCACCTTAA -> TTATAAATTTACCTTCACCTTAAG
GCGGCTACATGGAACGGGATTCCT -> CGGCTACATGGAACGGGATTCCTT
GACTGAGGTTGGCCCTTCATTTAG -> ACTGAGGTTGGCCCTTCATTTAGC
CGTGGAGGACCACTCGTCGTGCGC -> GTGGAGGACCACTCGTCGTGCGCG
GCCGGACCTTTTGTACAGTTCGTT -> CCGGACCTTTTGTACAGTTCGTTT
CTGTTGTCCGATAACACAAACAGT -> TGTTGTCCGATAACACAAACAGTG
CAGTTCGTTTAGTTAGAGGCCAGC -> AGTTCGTTTAGTTAGAGGCCAGCT
TACGCAGGATATTTTCTACAATTT -> ACGCAGGATATTTTCTACAATTTG
GTCCCGTCGGGCATAAATTCAACT -> TCCCGTCGGGCATAAATTCAACTG
TACTTCACTAGTGGGACTGGTGAG -> ACTTCACTAGTGGGACTGGTGAGT
TTTCGATGCCCCTACGCAGGATAT -> TTCGATGCCCCTACGCAGGATATT
CGTGGAGGAAAATACGGCACTTGG -> GTGGAGGAAAATACGGCACTTGGG
ACGATACCCACTGAGAGCGTATGA -> CGATACCCACTGAGAGCGTATGAC
TTGAGAGGAATCCACCAGCCTAGT -> TGAGAGGAATCCACCAGCCTAGTG
CTCACTTTTGTGAAGGTCTCGTCT -> TCACTTTTGTGAAGGTCTCGTCTC
AAGGAACACCGTTATGACCGCCAT -> AGGAACACCGTTATGACCGCCATA
AGGTCCTTCTAAGCGTTCCATGGG -> GGTCCTTCTAAGCGTTCCATGGGT
TGACCGCCATAAGTCCTTCTAACG -> GACCGCCATAAGTCCTTCTAACGA
GCCTCGCCAGCACATCATATGTGT -> CCTCGCCAGCACATCATATGTGTC
GCAATGATGAGCTAAATAGCGAAC -> CAATGATGAGCTAAATAGCGAACT
GTCGTGAAGAGGAGATGTTGCCTA -> TCGTGAAGAGGAGATGTTGCCTAA
CGTCATCCTGTAGGTCGAATGAGG -> GTCATCCTGTAGGTCGAATGAGGG
TGCGATGCGTGGATCATGCCATCT -> GCGATGCGTGGATCATGCCATCTA
AACCAGATGAGACAACAAAGAATG -> ACCAGATGAGACAACAAAGAATGA
GGCGTTGTACTCGTGCAGTCCTTT -> GCGTTGTACTCGTGCAGTCCTTTC
TGAGGATTTAGGGCTTTCACTATT -> GAGGATTTAGGGCTTTCACTATTA
CAACTGCCTCGCCAGCACATCATA -> AACTGCCTCGCCAGCACATCATAT
GATGCACTCCCCTCGTACTTTGGT -> ATGCACTCCCCTCGTACTTTGGTA
GGCTTTGTCTACTAGCCAAAGTTC -> GCTTTGTCTACTAGCCAAAGTTCG
GAAGGTCTCGTCTCACACTGGATC -> AAGGTCTCGTCTCACACTGGATCG
CACAAGCCACCGTTATTTCGCGTT -> ACAAGCCACCGTTATTTCGCGTTT
CCACTCGTCGTGCGCGCGTACGCC -> CACTCGTCGTGCGCGCGTACGCCA
GTCGTCTTGACCTGGGCAAACCTA -> TCGTCTTGACCTGGGCAAACCTAC
CGTTTTGTAATTTTTATGCAACTA -> GTTTTGTAATTTTTATGCAACTAT
TTCACTATTAAACCCTTATCCGTT -> TCACTATTAAACCCTTATCCGTTC
AAACGGTGACCCCCGGAGGAGCAT -> AACGGTGACCCCCGGAGGAGCATT
TTAAGGCGTCATCCTGTAGGTCGA -> TAAGGCGTCATCCTGTAGGTCGAA
CCAACTTTGAAGATAATCGTTTCG -> CAACTTTGAAGATAATCGTTTCGA
TCTACCACACTGACCTACGATATT -> CTACCACACTGACCTACGATATTT
GGGCTAGTCAGGGACATAGTTGTA -> GGCTAGTCAGGGACATAGTTGTAC
GGTATCTAATTACCAGAGCACAAG -> GTATCTAATTACCAGAGCACAAGC
CTTCACCGCTGCCCCCCCCATGCT -> TTCACCGCTGCCCCCCCCATGCTC
CGACGTAATGCCTGCTGGATGACG -> GACGTAATGCCTGCTGGATGACGC
CGGGCCCAAAAGGTAATGGTTCAG -> GGGCCCAAAAGGTAATGGTTCAGA
ATTTAGCAAATTCATGGGGAAAGA -> TTTAGCAAATTCATGGGGAAAGAG
GGTGGCTGCCGGATCCCCAACTGA -> GTGGCTGCCGGATCCCCAACTGAT
AATAAGCCCTTGTATAAACGGTGA -> ATAAGCCCTTGTATAAACGGTGAC
TCTGAGCCCGCCGTAGAGGCTTCC -> CTGAGCCCGCCGTAGAGGCTTCCA
GTGACAAGTTGGGTGGCTGCCGGA -> TGACAAGTTGGGTGGCTGCCGGAT
CCGCAGTACGTGCATAGGTCGTCT -> CGCAGTACGTGCATAGGTCGTCTT
CACCATTAGAGAAGCCCTATCGCC -> ACCATTAGAGAAGCCCTATCGCCG
GGTAATGGTTCAGATGCACTCCCC -> GTAATGGTTCAGATGCACTCCCCT
AGATGCACTCCCCTCGTACTTTGG -> GATGCACTCCCCTCGTACTTTGGT
GGGCTACCCGTATCTCTGAGCCCG -> GGCTACCCGTATCTCTGAGCCCGC
CCTACCCCCAGGTCCTTCTAAGCG -> CTACCCCCAGGTCCTTCTAAGCGT
CGGGATTCCTTGGCTTTGTCTACT -> GGGATTCCTTGGCTTTGTCTACTA
CTTGTATAAACGGTGACCCCCGGA -> TTGTATAAACGGTGACCCCCGGAG
GAGGTTGGCCCTTCATTTAGCAAA -> AGGTTGGCCCTTCATTTAGCAAAT
AATTTTTATGCAACTATAGTGCGC -> ATTTTTATGCAACTATAGTGCGCC
TTCACCGCTTAGGTGTATAAAAGT -> TCACCGCTTAGGTGTATAAAAGTC
ATCGGCTTCACCGCTGCCCCCCCC -> TCGGCTTCACCGCTGCCCCCCCCA
GGTCTTCTGGTGGACGCTCCTCCG -> GTCTTCTGGTGGACGCTCCTCCGT
ATCTATATAGTCAAATTTTCTCAC -> TCTATATAGTCAAATTTTCTCACT
GCATCCGGCCGAAGTGTATGTCTA -> CATCCGGCCGAAGTGTATGTCTAG
GCCGCGTGCACGATACCCACTGAG -> CCGCGTGCACGATACCCACTGAGA
CCTGTCTTACTTAAGCTTCAAGTG -> CTGTCTTACTTAAGCTTCAAGTGC
TTTAGCAAATTCATGGGGAAAGAG -> TTAGCAAATTCATGGGGAAAGAGC
CGTCGTCGGAAGACAGACTTGCTC -> GTCGTCGGAAGACAGACTTGCTCC
TATCCGTTCACAAGCCACCGTTAT -> ATCCGTTCACAAGCCACCGTTATT
TTGGCGTTCCGACTGGCTGGAGCC -> TGGCGTTCCGACTGGCTGGAGCCG
GGACTGGTGAGTGAATCGTCCGGC -> GACTGGTGAGTGAATCGTCCGGCC
AACTGATCGGCTTCACCGCTGCCC -> ACTGATCGGCTTCACCGCTGCCCC
ACGCAGGATATTTTCTACAATTTG -> CGCAGGATATTTTCTACAATTTGG
GTTTCTCAGTGTTGATTGATGCGG -> TTTCTCAGTGTTGATTGATGCGGC
AGACAGACTTGCTCCAGAGCATGA -> GACAGACTTGCTCCAGAGCATGAA
CGCCGTTTTGTAATTTTTATGCAA -> GCCGTTTTGTAATTTTTATGCAAC
CTAAGCGTTCCATGGGTCCCGTCG -> TAAGCGTTCCATGGGTCCCGTCGG
TGAAGAGGAGATGTTGCCTAAACG -> GAAGAGGAGATGTTGCCTAAACGT
TCCACCAGCCTAGTGTTCGCCTGC -> CCACCAGCCTAGTGTTCGCCTGCC
CATCATATGTGTCGTGAAGAGGAG -> ATCATATGTGTCGTGAAGAGGAGA
GGACCTTTTGTACAGTTCGTTTAG -> GACCTTTTGTACAGTTCGTTTAGT
GTGCGCGCGTACGCCACATCCTGT -> TGCGCGCGTACGCCACATCCTGTT
GAAGACAGACTTGCTCCAGAGCAT -> AAGACAGACTTGCTCCAGAGCATG
AGTGAATCGTCCGGCCGCGTGCAC -> GTGAATCGTCCGGCCGCGTGCACG
GATATTTTCTACAATTTGGAGTCA -> ATATTTTCTACAATTTGGAGTCAT
AGGTACGTAGAAAATACCAGGACA -> GGTACGTAGAAAATACCAGGACAA
CTTACTTAAGCTTCAAGTGCGATG -> TTACTTAAGCTTCAAGTGCGATGC
CAGAACGCTACCAGTAAGGAACAC -> AGAACGCTACCAGTAAGGAACACC
CCTCGTACTTTGGTAGATACAGAC -> CTCGTACTTTGGTAGATACAGACG
TGGAGGACCACTCGTCGTGCGCGC -> GGAGGACCACTCGTCGTGCGCGCG
GATTGATGCGGCTACATGGAACGG -> ATTGATGCGGCTACATGGAACGGG
CCCCCATGCTCGGCGTACAGAGTC -> CCCCATGCTCGGCGTACAGAGTCC
CTTATCCGTTCACAAGCCACCGTT -> TTATCCGTTCACAAGCCACCGTTA
TACATTGGTGTCATCGAAAGACTT -> ACATTGGTGTCATCGAAAGACTTT
GGTGTATAAAAGTCAGAGGAGCTG -> GTGTATAAAAGTCAGAGGAGCTGA
AGGAACACCGTTATGACCGCCATA -> GGAACACCGTTATGACCGCCATAA
CGACAGCAATGATGAGCTAAATAG -> GACAGCAATGATGAGCTAAATAGC
GTTATTTCGCGTTTCTCAGTGTTG -> TTATTTCGCGTTTCTCAGTGTTGA
AGAGAAGCCCTATCGCCGTTTTGT -> GAGAAGCCCTATCGCCGTTTTGTA
CGCACTACCACGGGCAAGTTACAT -> GCACTACCACGGGCAAGTTACATT
CGGACATCTACAACATCTCGCCGT -> GGACATCTACAACATCTCGCCGTT
TCGAATGAGGGGCTAGTCAGGGAC -> CGAATGAGGGGCTAGTCAGGGACA
CACATCATATGTGTCGTGAAGAGG -> ACATCATATGTGTCGTGAAGAGGA
CTTTAGAGTTGGCCACCCAGGATT -> TTTAGAGTTGGCCACCCAGGATTG
CTGGCTGGAGCCGTGGAGGAAAAT -> TGGCTGGAGCCGTGGAGGAAAATA
CGAACTGCAGGAAAATAACCAGAT -> GAACTGCAGGAAAATAACCAGATG
TCCCCCGCGGCACTGAGGCAGTAG -> CCCCCGCGGCACTGAGGCAGTAGT
TTTCGCTGTTGTCCGATAACACAA -> TTCGCTGTTGTCCGATAACACAAA
CGATGCTCGTCCTCATGGAGGCCC -> GATGCTCGTCCTCATGGAGGCCCC
CGTACAGAGTCCCCCGCGGCACTG -> GTACAGAGTCCCCCGCGGCACTGA
TCATTTAGCAAATTCATGGGGAAA -> CATTTAGCAAATTCATGGGGAAAG
ATAGCGAACTAATAAGCCCTTGTA -> TAGCGAACTAATAAGCCCTTGTAT
TTCGCTGTTGTCCGATAACACAAA -> TCGCTGTTGTCCGATAACACAAAC
GGCGGCAGCCCAGAATCCCGTATC -> GCGGCAGCCCAGAATCCCGTATCC
GCCCCGCACCTTGCACACACTAGG -> CCCCGCACCTTGCACACACTAGGG
CACACTAGGGCTACCCGTATCTCT -> ACACTAGGGCTACCCGTATCTCTG
ATGCTCGTCCTCATGGAGGCCCCG -> TGCTCGTCCTCATGGAGGCCCCGC
GAGGAATCCACCAGCCTAGTGTTC -> AGGAATCCACCAGCCTAGTGTTCG
GATCCCCAACTGATCGGCTTCACC -> ATCCCCAACTGATCGGCTTCACCG
ATTTGTGGTCAACAGGCGAACTGC -> TTTGTGGTCAACAGGCGAACTGCA
ATTGGTGTCATCGAAAGACTTTGG -> TTGGTGTCATCGAAAGACTTTGGC
TCAACGGGAACAACCAGGGCGGCA -> CAACGGGAACAACCAGGGCGGCAG
AGTCCCAACTTTGAAGATAATCGT -> GTCCCAACTTTGAAGATAATCGTT
GTCCTTTCAGGACGCGTCGGAAGG -> TCCTTTCAGGACGCGTCGGAAGGT
AAGTTACATTGGTGTCATCGAAAG -> AGTTACATTGGTGTCATCGAAAGA
CGGCACTGAGGCAGTAGTGGTATG -> GGCACTGAGGCAGTAGTGGTATGC
AGTGGTATGCTTACCGCCGGCTCG -> GTGGTATGCTTACCGCCGGCTCGA
AAGAGCGCACCATTAGAGAAGCCC -> AGAGCGCACCATTAGAGAAGCCCT
GTTCGCTTTTTGAGAGGAATCCAC -> TTCGCTTTTTGAGAGGAATCCACC
GACGGGAAGCCATAGTCGGCGGGA -> ACGGGAAGCCATAGTCGGCGGGAG
CGCTGCCCCCCCCATGCTCGGCGT -> GCTGCCCCCCCCATGCTCGGCGTA
GTATACGGGTATCTAATTACCAGA -> TATACGGGTATCTAATTACCAGAG
TACCACGGGCAAGTTACATTGGTG -> ACCACGGGCAAGTTACATTGGTGT
ATGCTTACCGCCGGCTCGATGCTC -> TGCTTACCGCCGGCTCGATGCTCG
TGAGAGCGTATGACTGTTTTTGCC -> GAGAGCGTATGACTGTTTTTGCCG
GGACATCTACAACATCTCGCCGTT -> GACATCTACAACATCTCGCCGTTG
TGATCGGCTTCACCGCTGCCCCCC -> GATCGGCTTCACCGCTGCCCCCCC
ATGAGCTAAATAGCGAACTAATAA -> TGAGCTAAATAGCGAACTAATAAG
CACATCCTGTTCACCGCTTAGGTG -> ACATCCTGTTCACCGCTTAGGTGT
TTGGGTGGCTGCCGGATCCCCAAC -> TGGGTGGCTGCCGGATCCCCAACT
CACAAACAGTGGCGGCCTCTTTAG -> ACAAACAGTGGCGGCCTCTTTAGA
CACAAGCCGACGATCGGCCTTTAT -> ACAAGCCGACGATCGGCCTTTATA
CGCCTGCCCGAGCAGAACGCTACC -> GCCTGCCCGAGCAGAACGCTACCA
AAGTGTATGTCTAGAGGGGGGAGT -> AGTGTATGTCTAGAGGGGGGAGTC
GTTGGACTGTTGGCGTTGTACTCG -> TTGGACTGTTGGCGTTGTACTCGT
GGTACGTAGAAAATACCAGGACAA -> GTACGTAGAAAATACCAGGACAAT
ATTTAGGGCTTTCACTATTAAACC -> TTTAGGGCTTTCACTATTAAACCC
ATACACGATCTGGTCTTCTGGTGG -> TACACGATCTGGTCTTCTGGTGGA
ACCCAGGATTGGCGCATACACGAT -> CCCAGGATTGGCGCATACACGATC
CCGATTCTGTTAAGGCGTCATCCT -> CGATTCTGTTAAGGCGTCATCCTG
CTCCCCTCGTACTTTGGTAGATAC -> TCCCCTCGTACTTTGGTAGATACA
CCCCCCCATGCTCGGCGTACAGAG -> CCCCCCATGCTCGGCGTACAGAGT
GCGATGCGTGGATCATGCCATCTA -> CGATGCGTGGATCATGCCATCTAT
GGATTCCTTGGCTTTGTCTACTAG -> GATTCCTTGGCTTTGTCTACTAGC
GTTTCGATGCCCCTACGCAGGATA -> TTTCGATGCCCCTACGCAGGATAT
TGCAACTATAGTGCGCCGACGTAA -> GCAACTATAGTGCGCCGACGTAAT
AGCCTAGTGTTCGCCTGCCCGAGC -> GCCTAGTGTTCGCCTGCCCGAGCA
GATGACCTACAGCGCAGTAACGTG -> ATGACCTACAGCGCAGTAACGTGA
TTTGGAGTCATGAGCCGGACCTTT -> TTGGAGTCATGAGCCGGACCTTTT
AGACTTTGGCGTTCCGACTGGCTG -> GACTTTGGCGTTCCGACTGGCTGG
ACCATTTTATGTTGTAATTCAACG -> CCATTTTATGTTGTAATTCAACGG
TCAAATTTTCTCACTTTTGTGAAG -> CAAATTTTCTCACTTTTGTGAAGG
CTGCCTCGCCAGCACATCATATGT -> TGCCTCGCCAGCACATCATATGTG
CGAACTAATAAGCCCTTGTATAAA -> GAACTAATAAGCCCTTGTATAAAC
TCCTGTTCACCGCTTAGGTGTATA -> CCTGTTCACCGCTTAGGTGTATAA
TGAACCGGACATCTACAACATCTC -> GAACCGGACATCTACAACATCTCG
GCCATCTATATAGTCAAATTTTCT -> CCATCTATATAGTCAAATTTTCTC
ATGTTGTAATTCAACGGGAACAAC -> TGTTGTAATTCAACGGGAACAACC
GCAGTAGTGGTATGCTTACCGCCG -> CAGTAGTGGTATGCTTACCGCCGG
ACTGTTTTTGCCGCATGCGACAGC -> CTGTTTTTGCCGCATGCGACAGCA
CGTTTAGTTAGAGGCCAGCTCCGC -> GTTTAGTTAGAGGCCAGCTCCGCG
TATCTCTGAGCCCGCCGTAGAGGC -> ATCTCTGAGCCCGCCGTAGAGGCT
GGTGGACGCTCCTCCGTGGAGGAC -> GTGGACGCTCCTCCGTGGAGGACC
GCCGTTGGGAGCGATGACCTACAG -> CCGTTGGGAGCGATGACCTACAGC
CACGATCTGGTCTTCTGGTGGACG -> ACGATCTGGTCTTCTGGTGGACGC
CGTCGTGCGCGCGTACGCCACATC -> GTCGTGCGCGCGTACGCCACATCC
GATCGGCTTCACCGCTGCCCCCCC -> ATCGGCTTCACCGCTGCCCCCCCC
TAGAGGCTTCCAGCTTGAGGATTT -> AGAGGCTTCCAGCTTGAGGATTTA
TAATTCAACGGGAACAACCAGGGC -> AATTCAACGGGAACAACCAGGGCG
CTTGGCTTTGTCTACTAGCCAAAG -> TTGGCTTTGTCTACTAGCCAAAGT
ACCACGGGCAAGTTACATTGGTGT -> CCACGGGCAAGTTACATTGGTGTC
TCGCCTGCCCGAGCAGAACGCTAC -> CGCCTGCCCGAGCAGAACGCTACC
GAGAGCGTATGACTGTTTTTGCCG -> AGAGCGTATGACTGTTTTTGCCGC
CAGGTAGTTGGACTGTTGGCGTTG -> AGGTAGTTGGACTGTTGGCGTTGT
GAATGAGGGGCTAGTCAGGGACAT -> AATGAGGGGCTAGTCAGGGACATA
GTACAGAGTCCCCCGCGGCACTGA -> TACAGAGTCCCCCGCGGCACTGAG
CCTTGCACACACTAGGGCTACCCG -> CTTGCACACACTAGGGCTACCCGT
GCGCCGACGTAATGCCTGCTGGAT -> CGCCGACGTAATGCCTGCTGGATG
GAGGAGCATTTCGCTGTTGTCCGA -> AGGAGCATTTCGCTGTTGTCCGAT
CCGTATCCCAATAATTCCGAAGAC -> CGTATCCCAATAATTCCGAAGACA
ACGTAATGCCTGCTGGATGACGCG -> CGTAATGCCTGCTGGATGACGCGT
TACCCACTAGTGTTTAATAACCAT -> ACCCACTAGTGTTTAATAACCATT
AAAGTCAGAGGAGCTGAGCGTCGA -> AAGTCAGAGGAGCTGAGCGTCGAC
AGGCGAACTGCAGGAAAATAACCA -> GGCGAACTGCAGGAAAATAACCAG
CTCCGTGGAGGACCACTCGTCGTG -> TCCGTGGAGGACCACTCGTCGTGC
AAGACTTTGGCGTTCCGACTGGCT -> AGACTTTGGCGTTCCGACTGGCTG
GTCAGGGACATAGTTGTACTTCAC -> TCAGGGACATAGTTGTACTTCACT
CGCATGCGCTACCCATAATACACT -> GCATGCGCTACCCATAATACACTG
ACTTGGGAAGTCCCAACTTTGAAG -> CTTGGGAAGTCCCAACTTTGAAGA
GGACAATTTGTGGTCAACAGGCGA -> GACAATTTGTGGTCAACAGGCGAA
GGTCCTTCTAAGCGTTCCATGGGT -> GTCCTTCTAAGCGTTCCATGGGTC
CAGCCTAGTGTTCGCCTGCCCGAG -> AGCCTAGTGTTCGCCTGCCCGAGC
GGAATCCACCAGCCTAGTGTTCGC -> GAATCCACCAGCCTAGTGTTCGCC
TCTTCTGGTGGACGCTCCTCCGTG -> CTTCTGGTGGACGCTCCTCCGTGG
TACGGGTATCTAATTACCAGAGCA -> ACGGGTATCTAATTACCAGAGCAC
TGCTCGGCGTACAGAGTCCCCCGC -> GCTCGGCGTACAGAGTCCCCCGCG
CAAAAGGTAATGGTTCAGATGCAC -> AAAAGGTAATGGTTCAGATGCACT
CTTTCACTATTAAACCCTTATCCG -> TTTCACTATTAAACCCTTATCCGT
CGACTGGCTGGAGCCGTGGAGGAA -> GACTGGCTGGAGCCGTGGAGGAAA
GCATTTCGCTGTTGTCCGATAACA -> CATTTCGCTGTTGTCCGATAACAC
TGAACGCAGTGCCCTACCCCCAGG -> GAACGCAGTGCCCTACCCCCAGGT
TGCCTAAACGTCGTCGGAAGACAG -> GCCTAAACGTCGTCGGAAGACAGA
ATTCTGTTAAGGCGTCATCCTGTA -> TTCTGTTAAGGCGTCATCCTGTAG
AGTCTACCCACTAGTGTTTAATAA -> GTCTACCCACTAGTGTTTAATAAC
TTAAACCCTTATCCGTTCACAAGC -> TAAACCCTTATCCGTTCACAAGCC
TGCGCCGACGTAATGCCTGCTGGA -> GCGCCGACGTAATGCCTGCTGGAT
CTCGTCGTGCGCGCGTACGCCACA -> TCGTCGTGCGCGCGTACGCCACAT
AGGATTGGCGCATACACGATCTGG -> GGATTGGCGCATACACGATCTGGT
TGCCATCTATATAGTCAAATTTTC -> GCCATCTATATAGTCAAATTTTCT
AATTCATGGGGAAAGAGCGCACCA -> ATTCATGGGGAAAGAGCGCACCAT
ACTGAGAGCGTATGACTGTTTTTG -> CTGAGAGCGTATGACTGTTTTTGC
CCCGCACCTTGCACACACTAGGGC -> CCGCACCTTGCACACACTAGGGCT
ACACTGACCTACGATATTTCGCAC -> CACTGACCTACGATATTTCGCACT
CTTAAGCTTCAAGTGCGATGCGTG -> TTAAGCTTCAAGTGCGATGCGTGG
GCCTCTTTAGAGTTGGCCACCCAG -> CCTCTTTAGAGTTGGCCACCCAGG
GGTCGAATGAGGGGCTAGTCAGGG -> GTCGAATGAGGGGCTAGTCAGGGA
CTCCTCCGTGGAGGACCACTCGTC -> TCCTCCGTGGAGGACCACTCGTCG
AAACGTCGTCGGAAGACAGACTTG -> AACGTCGTCGGAAGACAGACTTGC
CATGCCATCTATATAGTCAAATTT -> ATGCCATCTATATAGTCAAATTTT
TACATGGAACGGGATTCCTTGGCT -> ACATGGAACGGGATTCCTTGGCTT
TCGTCGGAAGACAGACTTGCTCCA -> CGTCGGAAGACAGACTTGCTCCAG
CCACTAGTGTTTAATAACCATTTT -> CACTAGTGTTTAATAACCATTTTA
TCAAGTGCGATGCGTGGATCATGC -> CAAGTGCGATGCGTGGATCATGCC
GAACGCTACCAGTAAGGAACACCG -> AACGCTACCAGTAAGGAACACCGT
ACACGATCTGGTCTTCTGGTGGAC -> CACGATCTGGTCTTCTGGTGGACG
ATGACTGTTTTTGCCGCATGCGAC -> TGACTGTTTTTGCCGCATGCGACA
AGCTTGAGGATTTAGGGCTTTCAC -> GCTTGAGGATTTAGGGCTTTCACT
CGGGCAAGTTACATTGGTGTCATC -> GGGCAAGTTACATTGGTGTCATCG
AAAATACCAGGACAATTTGTGGTC -> AAATACCAGGACAATTTGTGGTCA
GTTAAGGCGTCATCCTGTAGGTCG -> TTAAGGCGTCATCCTGTAGGTCGA
GGACATAGTTGTACTTCACTAGTG -> GACATAGTTGTACTTCACTAGTGG
GTGGTCAACAGGCGAACTGCAGGA -> TGGTCAACAGGCGAACTGCAGGAA
CGGTGACCCCCGGAGGAGCATTTC -> GGTGACCCCCGGAGGAGCATTTCG
GTTCGTTTAGTTAGAGGCCAGCTC -> TTCGTTTAGTTAGAGGCCAGCTCC
CGTGCGCGCGTACGCCACATCCTG -> GTGCGCGCGTACGCCACATCCTGT
AGAGCGTATGACTGTTTTTGCCGC -> GAGCGTATGACTGTTTTTGCCGCA
CCGAAGTGTATGTCTAGAGGGGGG -> CGAAGTGTATGTCTAGAGGGGGGA
CGTCCGGCCGCGTGCACGATACCC -> GTCCGGCCGCGTGCACGATACCCA
ACGTGCATAGGTCGTCTTGACCTG -> CGTGCATAGGTCGTCTTGACCTGG
GTTTTTGCCGCATGCGACAGCAAT -> TTTTTGCCGCATGCGACAGCAATG
TTATGCAACTATAGTGCGCCGACG -> TATGCAACTATAGTGCGCCGACGT
TTGTACAGTTCGTTTAGTTAGAGG -> TGTACAGTTCGTTTAGTTAGAGGC
TCTACCCACTAGTGTTTAATAACC -> CTACCCACTAGTGTTTAATAACCA
GTGAAGGTCTCGTCTCACACTGGA -> TGAAGGTCTCGTCTCACACTGGAT
GCGTTTCTCAGTGTTGATTGATGC -> CGTTTCTCAGTGTTGATTGATGCG
TGGCGTTCCGACTGGCTGGAGCCG -> GGCGTTCCGACTGGCTGGAGCCGT
GAATCCACCAGCCTAGTGTTCGCC -> AATCCACCAGCCTAGTGTTCGCCT
TATCCCAATAATTCCGAAGACAGG -> ATCCCAATAATTCCGAAGACAGGT
TACCCACTGAGAGCGTATGACTGT -> ACCCACTGAGAGCGTATGACTGTT
CCAGGACAATTTGTGGTCAACAGG -> CAGGACAATTTGTGGTCAACAGGC
GCCGACGATCGGCCTTTATAAATT -> CCGACGATCGGCCTTTATAAATTT
GACATCTACAACATCTCGCCGTTG -> ACATCTACAACATCTCGCCGTTGG
CCTTCTAAGCGTTCCATGGGTCCC -> CTTCTAAGCGTTCCATGGGTCCCG
GCCCTTGTATAAACGGTGACCCCC -> CCCTTGTATAAACGGTGACCCCCG
TAGTTAGAGGCCAGCTCCGCGGCC -> AGTTAGAGGCCAGCTCCGCGGCCG
GAGCCGGACCTTTTGTACAGTTCG -> AGCCGGACCTTTTGTACAGTTCGT
GCTTAGGTGTATAAAAGTCAGAGG -> CTTAGGTGTATAAAAGTCAGAGGA
CATAGTCGGCGGGAGCCGCATGCG -> ATAGTCGGCGGGAGCCGCATGCGC
TGTAATTCAACGGGAACAACCAGG -> GTAATTCAACGGGAACAACCAGGG
GGAGCCGTGGAGGAAAATACGGCA -> GAGCCGTGGAGGAAAATACGGCAC
TTGTCCGATAACACAAACAGTGGC -> TGTCCGATAACACAAACAGTGGCG
CAGAGTCCCCCGCGGCACTGAGGC -> AGAGTCCCCCGCGGCACTGAGGCA
ACTCTACCACACTGACCTACGATA -> CTCTACCACACTGACCTACGATAT
GACAAGTTGGGTGGCTGCCGGATC -> ACAAGTTGGGTGGCTGCCGGATCC
CCCACTAGTGTTTAATAACCATTT -> CCACTAGTGTTTAATAACCATTTT
GGCAGCCCAGAATCCCGTATCCCA -> GCAGCCCAGAATCCCGTATCCCAA
ATAATCGTTTCGATGCCCCTACGC -> TAATCGTTTCGATGCCCCTACGCA
TACTTTGGTAGATACAGACGGGAA -> ACTTTGGTAGATACAGACGGGAAG
TGAGCTAAATAGCGAACTAATAAG -> GAGCTAAATAGCGAACTAATAAGC
CCATTTTATGTTGTAATTCAACGG -> CATTTTATGTTGTAATTCAACGGG
GTTATGACCGCCATAAGTCCTTCT -> TTATGACCGCCATAAGTCCTTCTA
TCCTTCTAAGCGTTCCATGGGTCC -> CCTTCTAAGCGTTCCATGGGTCCC
CGGACCTTTTGTACAGTTCGTTTA -> GGACCTTTTGTACAGTTCGTTTAG
CTATTAAACCCTTATCCGTTCACA -> TATTAAACCCTTATCCGTTCACAA
TTAGGGCTTTCACTATTAAACCCT -> TAGGGCTTTCACTATTAAACCCTT
TCTACTCCACCGCAGTACGTGCAT -> CTACTCCACCGCAGTACGTGCATA
TCCGAAGACAGGTAGTTGGACTGT -> CCGAAGACAGGTAGTTGGACTGTT
TGTCCGATAACACAAACAGTGGCG -> GTCCGATAACACAAACAGTGGCGG
CGGGTATCTAATTACCAGAGCACA -> GGGTATCTAATTACCAGAGCACAA
TAAACGTCGTCGGAAGACAGACTT -> AAACGTCGTCGGAAGACAGACTTG
CAATGATGAGCTAAATAGCGAACT -> AATGATGAGCTAAATAGCGAACTA
GCATGCGACAGCAATGATGAGCTA -> CATGCGACAGCAATGATGAGCTAA
AGGGCGGCAGCCCAGAATCCCGTA -> GGGCGGCAGCCCAGAATCCCGTAT
TCCTTGGCTTTGTCTACTAGCCAA -> CCTTGGCTTTGTCTACTAGCCAAA
CAAGTGCGATGCGTGGATCATGCC -> AAGTGCGATGCGTGGATCATGCCA
GGCACTTGGGAAGTCCCAACTTTG -> GCACTTGGGAAGTCCCAACTTTGA
GCCCAGAATCCCGTATCCCAATAA -> CCCAGAATCCCGTATCCCAATAAT
CAGTACGTGCATAGGTCGTCTTGA -> AGTACGTGCATAGGTCGTCTTGAC
GGGATTCCTTGGCTTTGTCTACTA -> GGATTCCTTGGCTTTGTCTACTAG
GACGATCGGCCTTTATAAATTTAC -> ACGATCGGCCTTTATAAATTTACC
ATGCGCTACCCATAATACACTGAT -> TGCGCTACCCATAATACACTGATT
TTGATGCGGCTACATGGAACGGGA -> TGATGCGGCTACATGGAACGGGAT
GATTGGCGCATACACGATCTGGTC -> ATTGGCGCATACACGATCTGGTCT
TGGCTTTGTCTACTAGCCAAAGTT -> GGCTTTGTCTACTAGCCAAAGTTC
TGGCGTTGTACTCGTGCAGTCCTT -> GGCGTTGTACTCGTGCAGTCCTTT
TAAGCGTTCCATGGGTCCCGTCGG -> AAGCGTTCCATGGGTCCCGTCGGG
TTAATAACCATTTTATGTTGTAAT -> TAATAACCATTTTATGTTGTAATT
ACAGGTAGTTGGACTGTTGGCGTT -> CAGGTAGTTGGACTGTTGGCGTTG
GAGTCATGAGCCGGACCTTTTGTA -> AGTCATGAGCCGGACCTTTTGTAC
TAGAGGCCAGCTCCGCGGCCGGGC -> AGAGGCCAGCTCCGCGGCCGGGCC
AATAATTCCGAAGACAGGTAGTTG -> ATAATTCCGAAGACAGGTAGTTGG
AACGGGATTCCTTGGCTTTGTCTA -> ACGGGATTCCTTGGCTTTGTCTAC
CCGCATGCGCTACCCATAATACAC -> CGCATGCGCTACCCATAATACACT
GTTGTAATTCAACGGGAACAACCA -> TTGTAATTCAACGGGAACAACCAG
CGCAGGATATTTTCTACAATTTGG -> GCAGGATATTTTCTACAATTTGGA
GCAAACCTACCGATTCTGTTAAGG -> CAAACCTACCGATTCTGTTAAGGC
GTTGCCTAAACGTCGTCGGAAGAC -> TTGCCTAAACGTCGTCGGAAGACA
GTGGCGGCCTCTTTAGAGTTGGCC -> TGGCGGCCTCTTTAGAGTTGGCCA
GTTCACAAGCCACCGTTATTTCGC -> TTCACAAGCCACCGTTATTTCGCG
AATTTTCTCACTTTTGTGAAGGTC -> ATTTTCTCACTTTTGTGAAGGTCT
CGTTTCGATGCCCCTACGCAGGAT -> GTTTCGATGCCCCTACGCAGGATA
GACAGCAATGATGAGCTAAATAGC -> ACAGCAATGATGAGCTAAATAGCG
AGCTTCAAGTGCGATGCGTGGATC -> GCTTCAAGTGCGATGCGTGGATCA
TCACCGCTGCCCCCCCCATGCTCG -> CACCGCTGCCCCCCCCATGCTCGG
GTTGGCCACCCAGGATTGGCGCAT -> TTGGCCACCCAGGATTGGCGCATA
GAGCGATGACCTACAGCGCAGTAA -> AGCGATGACCTACAGCGCAGTAAC
GGGACTGGTGAGTGAATCGTCCGG -> GGACTGGTGAGTGAATCGTCCGGC
ACTGAGGCAGTAGTGGTATGCTTA -> CTGAGGCAGTAGTGGTATGCTTAC
TATCTAATTACCAGAGCACAAGCC -> ATCTAATTACCAGAGCACAAGCCG
CTTTGTCTACTAGCCAAAGTTCGC -> TTTGTCTACTAGCCAAAGTTCGCT
AAAGTTCGCTTTTTGAGAGGAATC -> AAGTTCGCTTTTTGAGAGGAATCC
GTCATGAGCCGGACCTTTTGTACA -> TCATGAGCCGGACCTTTTGTACAG
TGTCGTGAAGAGGAGATGTTGCCT -> GTCGTGAAGAGGAGATGTTGCCTA
ATCCACCAGCCTAGTGTTCGCCTG -> TCCACCAGCCTAGTGTTCGCCTGC
GCTGCCGGATCCCCAACTGATCGG -> CTGCCGGATCCCCAACTGATCGGC
CGCTTAGGTGTATAAAAGTCAGAG -> GCTTAGGTGTATAAAAGTCAGAGG
TACAGCGCAGTAACGTGACAAGTT -> ACAGCGCAGTAACGTGACAAGTTG
ATCCTGTTCACCGCTTAGGTGTAT -> TCCTGTTCACCGCTTAGGTGTATA
ATCGCATCCGGCCGAAGTGTATGT -> TCGCATCCGGCCGAAGTGTATGTC
TCCCGTATCCCAATAATTCCGAAG -> CCCGTATCCCAATAATTCCGAAGA
TTCCATGGGTCCCGTCGGGCATAA -> TCCATGGGTCCCGTCGGGCATAAA
ACCAGAGCACAAGCCGACGATCGG -> CCAGAGCACAAGCCGACGATCGGC
CTCGTCCTCATGGAGGCCCCGCAC -> TCGTCCTCATGGAGGCCCCGCACC
CCTTATCCGTTCACAAGCCACCGT -> CTTATCCGTTCACAAGCCACCGTT
TGAGCCCGCCGTAGAGGCTTCCAG -> GAGCCCGCCGTAGAGGCTTCCAGC
GTACTTCACTAGTGGGACTGGTGA -> TACTTCACTAGTGGGACTGGTGAG
CCAGAATCCCGTATCCCAATAATT -> CAGAATCCCGTATCCCAATAATTC
TAACCATTTTATGTTGTAATTCAA -> AACCATTTTATGTTGTAATTCAAC
ATGTTGCCTAAACGTCGTCGGAAG -> TGTTGCCTAAACGTCGTCGGAAGA
TACCGATTCTGTTAAGGCGTCATC -> ACCGATTCTGTTAAGGCGTCATCC
CGCCGTAGAGGCTTCCAGCTTGAG -> GCCGTAGAGGCTTCCAGCTTGAGG
CCCCCGCGGCACTGAGGCAGTAGT -> CCCCGCGGCACTGAGGCAGTAGTG
GCCATAAGTCCTTCTAACGACTGA -> CCATAAGTCCTTCTAACGACTGAG
GCACCATTAGAGAAGCCCTATCGC -> CACCATTAGAGAAGCCCTATCGCC
GACTGGCTGGAGCCGTGGAGGAAA -> ACTGGCTGGAGCCGTGGAGGAAAA
CCGCACCTTGCACACACTAGGGCT -> CGCACCTTGCACACACTAGGGCTA
CAGTGTTGATTGATGCGGCTACAT -> AGTGTTGATTGATGCGGCTACATG
TCCGTTCACAAGCCACCGTTATTT -> CCGTTCACAAGCCACCGTTATTTC
AAATAGCGAACTAATAAGCCCTTG -> AATAGCGAACTAATAAGCCCTTGT
TAGTCGGCGGGAGCCGCATGCGCT -> AGTCGGCGGGAGCCGCATGCGCTA
TGTTCGCCTGCCCGAGCAGAACGC -> GTTCGCCTGCCCGAGCAGAACGCT
TTCATTTAGCAAATTCATGGGGAA -> TCATTTAGCAAATTCATGGGGAAA
TGGAACGGGATTCCTTGGCTTTGT -> GGAACGGGATTCCTTGGCTTTGTC
GATTCCTTGGCTTTGTCTACTAGC -> ATTCCTTGGCTTTGTCTACTAGCC
AGAACGCTACCAGTAAGGAACACC -> GAACGCTACCAGTAAGGAACACCG
AAATTTACCTTCACCTTAAGCCCG -> AATTTACCTTCACCTTAAGCCCGT
CTAGTGGGACTGGTGAGTGAATCG -> TAGTGGGACTGGTGAGTGAATCGT
TGTCATCGAAAGACTTTGGCGTTC -> GTCATCGAAAGACTTTGGCGTTCC
CAGGACAATTTGTGGTCAACAGGC -> AGGACAATTTGTGGTCAACAGGCG
CGTGAAGAGGAGATGTTGCCTAAA -> GTGAAGAGGAGATGTTGCCTAAAC
GTGCGATGCGTGGATCATGCCATC -> TGCGATGCGTGGATCATGCCATCT
GGGTATCTAATTACCAGAGCACAA -> GGTATCTAATTACCAGAGCACAAG
ATTTTTATGCAACTATAGTGCGCC -> TTTTTATGCAACTATAGTGCGCCG
CATAAGTCCTTCTAACGACTGAGG -> ATAAGTCCTTCTAACGACTGAGGT
CCCGTATCTCTGAGCCCGCCGTAG -> CCGTATCTCTGAGCCCGCCGTAGA
AGCTGAGCGTCGACTCTACCACAC -> GCTGAGCGTCGACTCTACCACACT
TACCCGTATCTCTGAGCCCGCCGT -> ACCCGTATCTCTGAGCCCGCCGTA
ATCGAAAGACTTTGGCGTTCCGAC -> TCGAAAGACTTTGGCGTTCCGACT
GTGAATCGTCCGGCCGCGTGCACG -> TGAATCGTCCGGCCGCGTGCACGA
GAGCACAAGCCGACGATCGGCCTT -> AGCACAAGCCGACGATCGGCCTTT
TTTATGTTGTAATTCAACGGGAAC -> TTATGTTGTAATTCAACGGGAACA
GACTGTTGGCGTTGTACTCGTGCA -> ACTGTTGGCGTTGTACTCGTGCAG
GCGTGCACGATACCCACTGAGAGC -> CGTGCACGATACCCACTGAGAGCG
CACCTTAAGCCCGTAATTATTCAT -> ACCTTAAGCCCGTAATTATTCATC
GCTACATGGAACGGGATTCCTTGG -> CTACATGGAACGGGATTCCTTGGC
TACCAGGACAATTTGTGGTCAACA -> ACCAGGACAATTTGTGGTCAACAG
ACGCGTATACGGGTATCTAATTAC -> CGCGTATACGGGTATCTAATTACC
TCATATGTGTCGTGAAGAGGAGAT -> CATATGTGTCGTGAAGAGGAGATG
CCTACGATATTTCGCACTACCACG -> CTACGATATTTCGCACTACCACGG
ACTCCCCTCGTACTTTGGTAGATA -> CTCCCCTCGTACTTTGGTAGATAC
CCACACTGACCTACGATATTTCGC -> CACACTGACCTACGATATTTCGCA
TTGTCTACTAGCCAAAGTTCGCTT -> TGTCTACTAGCCAAAGTTCGCTTT
GTTCAGATGCACTCCCCTCGTACT -> TTCAGATGCACTCCCCTCGTACTT
AACGACTGAGGTTGGCCCTTCATT -> ACGACTGAGGTTGGCCCTTCATTT
CGTTATTTCGCGTTTCTCAGTGTT -> GTTATTTCGCGTTTCTCAGTGTTG
AAAGAGCGCACCATTAGAGAAGCC -> AAGAGCGCACCATTAGAGAAGCCC
CGTTGTACTCGTGCAGTCCTTTCA -> GTTGTACTCGTGCAGTCCTTTCAG
AGGTTGGCCCTTCATTTAGCAAAT -> GGTTGGCCCTTCATTTAGCAAATT
GCCGTAGAGGCTTCCAGCTTGAGG -> CCGTAGAGGCTTCCAGCTTGAGGA
GTGTCGTGAAGAGGAGATGTTGCC -> TGTCGTGAAGAGGAGATGTTGCCT
GAAGCCATAGTCGGCGGGAGCCGC -> AAGCCATAGTCGGCGGGAGCCGCA
GAAAATACGGCACTTGGGAAGTCC -> AAAATACGGCACTTGGGAAGTCCC
GTCCTTCTAACGACTGAGGTTGGC -> TCCTTCTAACGACTGAGGTTGGCC
CCACATCCTGTTCACCGCTTAGGT -> CACATCCTGTTCACCGCTTAGGTG
CTCTACCACACTGACCTACGATAT -> TCTACCACACTGACCTACGATATT
TTGGGAAGTCCCAACTTTGAAGAT -> TGGGAAGTCCCAACTTTGAAGATA
TCGGAAGACAGACTTGCTCCAGAG -> CGGAAGACAGACTTGCTCCAGAGC
GACTTTGGCGTTCCGACTGGCTGG -> ACTTTGGCGTTCCGACTGGCTGGA
GTGCACGATACCCACTGAGAGCGT -> TGCACGATACCCACTGAGAGCGTA
CCTCTTTAGAGTTGGCCACCCAGG -> CTCTTTAGAGTTGGCCACCCAGGA
AACGCTACCAGTAAGGAACACCGT -> ACGCTACCAGTAAGGAACACCGTT
GTTGAACCGGACATCTACAACATC -> TTGAACCGGACATCTACAACATCT
GTCCCAACTTTGAAGATAATCGTT -> TCCCAACTTTGAAGATAATCGTTT
TAGTCAGGGACATAGTTGTACTTC -> AGTCAGGGACATAGTTGTACTTCA
ACCACACTGACCTACGATATTTCG -> CCACACTGACCTACGATATTTCGC
CATAGGTCGTCTTGACCTGGGCAA -> ATAGGTCGTCTTGACCTGGGCAAA
AAAAGTCAGAGGAGCTGAGCGTCG -> AAAGTCAGAGGAGCTGAGCGTCGA
CTGAGCCCGCCGTAGAGGCTTCCA -> TGAGCCCGCCGTAGAGGCTTCCAG
AGCTCCGCGGCCGGGCCCAAAAGG -> GCTCCGCGGCCGGGCCCAAAAGGT
CGCTCCTCCGTGGAGGACCACTCG -> GCTCCTCCGTGGAGGACCACTCGT
TTGAGGATTTAGGGCTTTCACTAT -> TGAGGATTTAGGGCTTTCACTATT
CACTTGGGAAGTCCCAACTTTGAA -> ACTTGGGAAGTCCCAACTTTGAAG
GGAGTCATGAGCCGGACCTTTTGT -> GAGTCATGAGCCGGACCTTTTGTA
TTGGCGCATACACGATCTGGTCTT -> TGGCGCATACACGATCTGGTCTTC
CCCGTATCCCAATAATTCCGAAGA -> CCGTATCCCAATAATTCCGAAGAC
GGGCGGCAGCCCAGAATCCCGTAT -> GGCGGCAGCCCAGAATCCCGTATC
CTCGGCGTACAGAGTCCCCCGCGG -> TCGGCGTACAGAGTCCCCCGCGGC
GTGTTGATTGATGCGGCTACATGG -> TGTTGATTGATGCGGCTACATGGA
TGCCTCGCCAGCACATCATATGTG -> GCCTCGCCAGCACATCATATGTGT
CTGAGCGTCGACTCTACCACACTG -> TGAGCGTCGACTCTACCACACTGA
CAACGGGAACAACCAGGGCGGCAG -> AACGGGAACAACCAGGGCGGCAGC
GTATGTCTAGAGGGGGGAGTCTAC -> TATGTCTAGAGGGGGGAGTCTACC
TATGCTTACCGCCGGCTCGATGCT -> ATGCTTACCGCCGGCTCGATGCTC
CCCCTCGTACTTTGGTAGATACAG -> CCCTCGTACTTTGGTAGATACAGA
CTATAGTGCGCCGACGTAATGCCT -> TATAGTGCGCCGACGTAATGCCTG
CGTAATGCCTGCTGGATGACGCGT -> GTAATGCCTGCTGGATGACGCGTA
GTATGCTTACCGCCGGCTCGATGC -> TATGCTTACCGCCGGCTCGATGCT
CAGCTCCGCGGCCGGGCCCAAAAG -> AGCTCCGCGGCCGGGCCCAAAAGG
GTCGGAAGACAGACTTGCTCCAGA -> TCGGAAGACAGACTTGCTCCAGAG
TTTTGCCGCATGCGACAGCAATGA -> TTTGCCGCATGCGACAGCAATGAT
GCTTCACCGCTGCCCCCCCCATGC -> CTTCACCGCTGCCCCCCCCATGCT
ACGCGTCGGAAGGTACGTAGAAAA -> CGCGTCGGAAGGTACGTAGAAAAT
GCCACATCCTGTTCACCGCTTAGG -> CCACATCCTGTTCACCGCTTAGGT
ATGTATGTTGAACCGGACATCTAC -> TGTATGTTGAACCGGACATCTACA
CAAAGTTCGCTTTTTGAGAGGAAT -> AAAGTTCGCTTTTTGAGAGGAATC
GACAACAAAGAATGAACGCAGTGC -> ACAACAAAGAATGAACGCAGTGCC
TATTTTCTACAATTTGGAGTCATG -> ATTTTCTACAATTTGGAGTCATGA
CAGTAACGTGACAAGTTGGGTGGC -> AGTAACGTGACAAGTTGGGTGGCT
TCGGCTTCACCGCTGCCCCCCCCA -> CGGCTTCACCGCTGCCCCCCCCAT
TTGCTCCAGAGCATGAATGTATGT -> TGCTCCAGAGCATGAATGTATGTT
GTTACATTGGTGTCATCGAAAGAC -> TTACATTGGTGTCATCGAAAGACT
CCCCTACGCAGGATATTTTCTACA -> CCCTACGCAGGATATTTTCTACAA
ATTTTCTCACTTTTGTGAAGGTCT -> TTTTCTCACTTTTGTGAAGGTCTC
CTACAACATCTCGCCGTTGGGAGC -> TACAACATCTCGCCGTTGGGAGCG
TAGGTCGTCTTGACCTGGGCAAAC -> AGGTCGTCTTGACCTGGGCAAACC
TGTATAAACGGTGACCCCCGGAGG -> GTATAAACGGTGACCCCCGGAGGA
TTCGATGCCCCTACGCAGGATATT -> TCGATGCCCCTACGCAGGATATTT
GAGGCAGTAGTGGTATGCTTACCG -> AGGCAGTAGTGGTATGCTTACCGC
TAAGTCCTTCTAACGACTGAGGTT -> AAGTCCTTCTAACGACTGAGGTTG
ACCGATTCTGTTAAGGCGTCATCC -> CCGATTCTGTTAAGGCGTCATCCT
CCCAGGATTGGCGCATACACGATC -> CCAGGATTGGCGCATACACGATCT
TGTAATTTTTATGCAACTATAGTG -> GTAATTTTTATGCAACTATAGTGC
CCTGCCCGAGCAGAACGCTACCAG -> CTGCCCGAGCAGAACGCTACCAGT
GGAAGCCATAGTCGGCGGGAGCCG -> GAAGCCATAGTCGGCGGGAGCCGC
TCATCTACTCCACCGCAGTACGTG -> CATCTACTCCACCGCAGTACGTGC
ATTTTATGTTGTAATTCAACGGGA -> TTTTATGTTGTAATTCAACGGGAA
CTGAGGCAGTAGTGGTATGCTTAC -> TGAGGCAGTAGTGGTATGCTTACC
AAGTTGGGTGGCTGCCGGATCCCC -> AGTTGGGTGGCTGCCGGATCCCCA
CTTCTAAGCGTTCCATGGGTCCCG -> TTCTAAGCGTTCCATGGGTCCCGT
TTACCAGAGCACAAGCCGACGATC -> TACCAGAGCACAAGCCGACGATCG
GATGAGACAACAAAGAATGAACGC -> ATGAGACAACAAAGAATGAACGCA
GCCGGGCCCAAAAGGTAATGGTTC -> CCGGGCCCAAAAGGTAATGGTTCA
CAGGGCGGCAGCCCAGAATCCCGT -> AGGGCGGCAGCCCAGAATCCCGTA
GCTGAGCGTCGACTCTACCACACT -> CTGAGCGTCGACTCTACCACACTG
CGCATACACGATCTGGTCTTCTGG -> GCATACACGATCTGGTCTTCTGGT
GCACTTGGGAAGTCCCAACTTTGA -> CACTTGGGAAGTCCCAACTTTGAA
CCATAAGTCCTTCTAACGACTGAG -> CATAAGTCCTTCTAACGACTGAGG
CAAGTTACATTGGTGTCATCGAAA -> AAGTTACATTGGTGTCATCGAAAG
TTTGCCGCATGCGACAGCAATGAT -> TTGCCGCATGCGACAGCAATGATG
GACCCCCGGAGGAGCATTTCGCTG -> ACCCCCGGAGGAGCATTTCGCTGT
TGGCCACCCAGGATTGGCGCATAC -> GGCCACCCAGGATTGGCGCATACA
CCGGATCCCCAACTGATCGGCTTC -> CGGATCCCCAACTGATCGGCTTCA
ATCGCCGTTTTGTAATTTTTATGC -> TCGCCGTTTTGTAATTTTTATGCA
TTGGCCACCCAGGATTGGCGCATA -> TGGCCACCCAGGATTGGCGCATAC
GGAGGCCCCGCACCTTGCACACAC -> GAGGCCCCGCACCTTGCACACACT
TTGGTGTCATCGAAAGACTTTGGC -> TGGTGTCATCGAAAGACTTTGGCG
ATCCGTTCACAAGCCACCGTTATT -> TCCGTTCACAAGCCACCGTTATTT
TGGCGGCCTCTTTAGAGTTGGCCA -> GGCGGCCTCTTTAGAGTTGGCCAC
CCCCCCATGCTCGGCGTACAGAGT -> CCCCCATGCTCGGCGTACAGAGTC
TGGCTGCCGGATCCCCAACTGATC -> GGCTGCCGGATCCCCAACTGATCG
TTCGCTTTTTGAGAGGAATCCACC -> TCGCTTTTTGAGAGGAATCCACCA
GAACAACCAGGGCGGCAGCCCAGA -> AACAACCAGGGCGGCAGCCCAGAA
TGCCGCATGCGACAGCAATGATGA -> GCCGCATGCGACAGCAATGATGAG
TGCTGGATGACGCGTATACGGGTA -> GCTGGATGACGCGTATACGGGTAT
AAGTGCGATGCGTGGATCATGCCA -> AGTGCGATGCGTGGATCATGCCAT
GAGGAGATGTTGCCTAAACGTCGT -> AGGAGATGTTGCCTAAACGTCGTC
GAGCATGAATGTATGTTGAACCGG -> AGCATGAATGTATGTTGAACCGGA
CCACCAGCCTAGTGTTCGCCTGCC -> CACCAGCCTAGTGTTCGCCTGCCC
CCGGCCGCGTGCACGATACCCACT -> CGGCCGCGTGCACGATACCCACTG
CGGCCGCGTGCACGATACCCACTG -> GGCCGCGTGCACGATACCCACTGA
GGAGCCGCATGCGCTACCCATAAT -> GAGCCGCATGCGCTACCCATAATA
GCGGCCTCTTTAGAGTTGGCCACC -> CGGCCTCTTTAGAGTTGGCCACCC
CACCTTGCACACACTAGGGCTACC -> ACCTTGCACACACTAGGGCTACCC
TTGTAATTTTTATGCAACTATAGT -> TGTAATTTTTATGCAACTATAGTG
GAGATGTTGCCTAAACGTCGTCGG -> AGATGTTGCCTAAACGTCGTCGGA
GCACACACTAGGGCTACCCGTATC -> CACACACTAGGGCTACCCGTATCT
TTCCGAAGACAGGTAGTTGGACTG -> TCCGAAGACAGGTAGTTGGACTGT
TTCTGTTAAGGCGTCATCCTGTAG -> TCTGTTAAGGCGTCATCCTGTAGG
GGCCTTTATAAATTTACCTTCACC -> GCCTTTATAAATTTACCTTCACCT
GAGCATTTCGCTGTTGTCCGATAA -> AGCATTTCGCTGTTGTCCGATAAC
TTCCAGCTTGAGGATTTAGGGCTT -> TCCAGCTTGAGGATTTAGGGCTTT
GAAGCCCTATCGCCGTTTTGTAAT -> AAGCCCTATCGCCGTTTTGTAATT
CCCCGCACCTTGCACACACTAGGG -> CCCGCACCTTGCACACACTAGGGC
CCCAACTTTGAAGATAATCGTTTC -> CCAACTTTGAAGATAATCGTTTCG
TCCTGTAGGTCGAATGAGGGGCTA -> CCTGTAGGTCGAATGAGGGGCTAG
TGGTGTCATCGAAAGACTTTGGCG -> GGTGTCATCGAAAGACTTTGGCGT
CCAGCTTGAGGATTTAGGGCTTTC -> CAGCTTGAGGATTTAGGGCTTTCA
GGAACACCGTTATGACCGCCATAA -> GAACACCGTTATGACCGCCATAAG
TGGTCAACAGGCGAACTGCAGGAA -> GGTCAACAGGCGAACTGCAGGAAA
TTACATTGGTGTCATCGAAAGACT -> TACATTGGTGTCATCGAAAGACTT
TTATAAATTTACCTTCACCTTAAG -> TATAAATTTACCTTCACCTTAAGC
AACTGCAGGAAAATAACCAGATGA -> ACTGCAGGAAAATAACCAGATGAG
TATGTTGTAATTCAACGGGAACAA -> ATGTTGTAATTCAACGGGAACAAC
TGTGAAGGTCTCGTCTCACACTGG -> GTGAAGGTCTCGTCTCACACTGGA
GGGGAAAGAGCGCACCATTAGAGA -> GGGAAAGAGCGCACCATTAGAGAA
CGTTATGACCGCCATAAGTCCTTC -> GTTATGACCGCCATAAGTCCTTCT
CGTTGGGAGCGATGACCTACAGCG -> GTTGGGAGCGATGACCTACAGCGC
CTGAGAGCGTATGACTGTTTTTGC -> TGAGAGCGTATGACTGTTTTTGCC
GAGGGGGGAGTCTACCCACTAGTG -> AGGGGGGAGTCTACCCACTAGTGT
CGCAGTGCCCTACCCCCAGGTCCT -> GCAGTGCCCTACCCCCAGGTCCTT
AGAAGCCCTATCGCCGTTTTGTAA -> GAAGCCCTATCGCCGTTTTGTAAT
GAGAGGAATCCACCAGCCTAGTGT -> AGAGGAATCCACCAGCCTAGTGTT
ATGACGCGTATACGGGTATCTAAT -> TGACGCGTATACGGGTATCTAATT
CACTCCCCTCGTACTTTGGTAGAT -> ACTCCCCTCGTACTTTGGTAGATA
TTAAGCCCGTAATTATTCATCTAC -> TAAGCCCGTAATTATTCATCTACT
GTCTTGACCTGGGCAAACCTACCG -> TCTTGACCTGGGCAAACCTACCGA
ATACAGACGGGAAGCCATAGTCGG -> TACAGACGGGAAGCCATAGTCGGC
CTACGATATTTCGCACTACCACGG -> TACGATATTTCGCACTACCACGGG
TAACGACTGAGGTTGGCCCTTCAT -> AACGACTGAGGTTGGCCCTTCATT
TAGCAAATTCATGGGGAAAGAGCG -> AGCAAATTCATGGGGAAAGAGCGC
AACAACCAGGGCGGCAGCCCAGAA -> ACAACCAGGGCGGCAGCCCAGAAT
CGGGAACAACCAGGGCGGCAGCCC -> GGGAACAACCAGGGCGGCAGCCCA
GTGAAGAGGAGATGTTGCCTAAAC -> TGAAGAGGAGATGTTGCCTAAACG
CTTGGGAAGTCCCAACTTTGAAGA -> TTGGGAAGTCCCAACTTTGAAGAT
TCCGGCCGCGTGCACGATACCCAC -> CCGGCCGCGTGCACGATACCCACT
GTGGGACTGGTGAGTGAATCGTCC -> TGGGACTGGTGAGTGAATCGTCCG
CGACTCTACCACACTGACCTACGA -> GACTCTACCACACTGACCTACGAT
TGGCTGGAGCCGTGGAGGAAAATA -> GGCTGGAGCCGTGGAGGAAAATAC
CTCCACCGCAGTACGTGCATAGGT -> TCCACCGCAGTACGTGCATAGGTC
CTAGTGTTCGCCTGCCCGAGCAGA -> TAGTGTTCGCCTGCCCGAGCAGAA
ACCCCCGGAGGAGCATTTCGCTGT -> CCCCCGGAGGAGCATTTCGCTGTT
GGGAACAACCAGGGCGGCAGCCCA -> GGAACAACCAGGGCGGCAGCCCAG
CTTACCGCCGGCTCGATGCTCGTC -> TTACCGCCGGCTCGATGCTCGTCC
AAGCCACCGTTATTTCGCGTTTCT -> AGCCACCGTTATTTCGCGTTTCTC
ATTGGCGCATACACGATCTGGTCT -> TTGGCGCATACACGATCTGGTCTT
GGGCATAAATTCAACTGCCTCGCC -> GGCATAAATTCAACTGCCTCGCCA
GCCCTATCGCCGTTTTGTAATTTT -> CCCTATCGCCGTTTTGTAATTTTT
TTGTAATTCAACGGGAACAACCAG -> TGTAATTCAACGGGAACAACCAGG
CACTGAGGCAGTAGTGGTATGCTT -> ACTGAGGCAGTAGTGGTATGCTTA
ATTCAACTGCCTCGCCAGCACATC -> TTCAACTGCCTCGCCAGCACATCA
CATCCTGTAGGTCGAATGAGGGGC -> ATCCTGTAGGTCGAATGAGGGGCT
CAAGCCGACGATCGGCCTTTATAA -> AAGCCGACGATCGGCCTTTATAAA
GGTAGTTGGACTGTTGGCGTTGTA -> GTAGTTGGACTGTTGGCGTTGTAC
TCGCATCCGGCCGAAGTGTATGTC -> CGCATCCGGCCGAAGTGTATGTCT
AAATTCAACTGCCTCGCCAGCACA -> AATTCAACTGCCTCGCCAGCACAT
GTGGATCATGCCATCTATATAGTC -> TGGATCATGCCATCTATATAGTCA
ACTTTGGTAGATACAGACGGGAAG -> CTTTGGTAGATACAGACGGGAAGC
GTGACCCCCGGAGGAGCATTTCGC -> TGACCCCCGGAGGAGCATTTCGCT
GCCGACGTAATGCCTGCTGGATGA -> CCGACGTAATGCCTGCTGGATGAC
TTGTACTCGTGCAGTCCTTTCAGG -> TGTACTCGTGCAGTCCTTTCAGGA
ATGAGGGGCTAGTCAGGGACATAG -> TGAGGGGCTAGTCAGGGACATAGT
ACCCGTATCTCTGAGCCCGCCGTA -> CCCGTATCTCTGAGCCCGCCGTAG
CCCAATAATTCCGAAGACAGGTAG -> CCAATAATTCCGAAGACAGGTAGT
GAGGCCCCGCACCTTGCACACACT -> AGGCCCCGCACCTTGCACACACTA
AACGTGACAAGTTGGGTGGCTGCC -> ACGTGACAAGTTGGGTGGCTGCCG
CACTAGGGCTACCCGTATCTCTGA -> ACTAGGGCTACCCGTATCTCTGAG
CATTTTATGTTGTAATTCAACGGG -> ATTTTATGTTGTAATTCAACGGGA
CATTTAGCAAATTCATGGGGAAAG -> ATTTAGCAAATTCATGGGGAAAGA
AGGGGGGAGTCTACCCACTAGTGT -> GGGGGGAGTCTACCCACTAGTGTT
ACAACCAGGGCGGCAGCCCAGAAT -> CAACCAGGGCGGCAGCCCAGAATC
ATGAACGCAGTGCCCTACCCCCAG -> TGAACGCAGTGCCCTACCCCCAGG
TTTAGAGTTGGCCACCCAGGATTG -> TTAGAGTTGGCCACCCAGGATTGG
GCTGCCCCCCCCATGCTCGGCGTA -> CTGCCCCCCCCATGCTCGGCGTAC
GATCTGGTCTTCTGGTGGACGCTC -> ATCTGGTCTTCTGGTGGACGCTCC
CGGAAGACAGACTTGCTCCAGAGC -> GGAAGACAGACTTGCTCCAGAGCA
TCGGAAGGTACGTAGAAAATACCA -> CGGAAGGTACGTAGAAAATACCAG
ATGTCTAGAGGGGGGAGTCTACCC -> TGTCTAGAGGGGGGAGTCTACCCA
CGATGCCCCTACGCAGGATATTTT -> GATGCCCCTACGCAGGATATTTTC
GACCTTTTGTACAGTTCGTTTAGT -> ACCTTTTGTACAGTTCGTTTAGTT
ATGAGCCGGACCTTTTGTACAGTT -> TGAGCCGGACCTTTTGTACAGTTC
AGCCAAAGTTCGCTTTTTGAGAGG -> GCCAAAGTTCGCTTTTTGAGAGGA
TGACGCGTATACGGGTATCTAATT -> GACGCGTATACGGGTATCTAATTA
TAGGGCTTTCACTATTAAACCCTT -> AGGGCTTTCACTATTAAACCCTTA
AGATGAGACAACAAAGAATGAACG -> GATGAGACAACAAAGAATGAACGC
CTGGATGACGCGTATACGGGTATC -> TGGATGACGCGTATACGGGTATCT
CGGGAAGCCATAGTCGGCGGGAGC -> GGGAAGCCATAGTCGGCGGGAGCC
CCTAAACGTCGTCGGAAGACAGAC -> CTAAACGTCGTCGGAAGACAGACT
TAAGCCCGTAATTATTCATCTACT -> AAGCCCGTAATTATTCATCTACTC
GGAAGGTACGTAGAAAATACCAGG -> GAAGGTACGTAGAAAATACCAGGA
GCTAGTCAGGGACATAGTTGTACT -> CTAGTCAGGGACATAGTTGTACTT
TCGCGTTTCTCAGTGTTGATTGAT -> CGCGTTTCTCAGTGTTGATTGATG
CCTTCATTTAGCAAATTCATGGGG -> CTTCATTTAGCAAATTCATGGGGA
TTTCAGGACGCGTCGGAAGGTACG -> TTCAGGACGCGTCGGAAGGTACGT
CAGAGCACAAGCCGACGATCGGCC -> AGAGCACAAGCCGACGATCGGCCT
TTCACCGCTGCCCCCCCCATGCTC -> TCACCGCTGCCCCCCCCATGCTCG
CTAGCCAAAGTTCGCTTTTTGAGA -> TAGCCAAAGTTCGCTTTTTGAGAG
TTGGCTTTGTCTACTAGCCAAAGT -> TGGCTTTGTCTACTAGCCAAAGTT
GGGAAAGAGCGCACCATTAGAGAA -> GGAAAGAGCGCACCATTAGAGAAG
CCGGACATCTACAACATCTCGCCG -> CGGACATCTACAACATCTCGCCGT
TGTATGTTGAACCGGACATCTACA -> GTATGTTGAACCGGACATCTACAA
GAAAATAACCAGATGAGACAACAA -> AAAATAACCAGATGAGACAACAAA
CCGACGTAATGCCTGCTGGATGAC -> CGACGTAATGCCTGCTGGATGACG
ACAATTTGTGGTCAACAGGCGAAC -> CAATTTGTGGTCAACAGGCGAACT
GCCTTTATAAATTTACCTTCACCT -> CCTTTATAAATTTACCTTCACCTT
CAGCACATCATATGTGTCGTGAAG -> AGCACATCATATGTGTCGTGAAGA
CTAATAAGCCCTTGTATAAACGGT -> TAATAAGCCCTTGTATAAACGGTG
GGTGAGTGAATCGTCCGGCCGCGT -> GTGAGTGAATCGTCCGGCCGCGTG
TTTAGTTAGAGGCCAGCTCCGCGG -> TTAGTTAGAGGCCAGCTCCGCGGC
GAGTCCCCCGCGGCACTGAGGCAG -> AGTCCCCCGCGGCACTGAGGCAGT
CGCGGCACTGAGGCAGTAGTGGTA -> GCGGCACTGAGGCAGTAGTGGTAT
CCCTACCCCCAGGTCCTTCTAAGC -> CCTACCCCCAGGTCCTTCTAAGCG
AACGTCGTCGGAAGACAGACTTGC -> ACGTCGTCGGAAGACAGACTTGCT
TGGGAAGTCCCAACTTTGAAGATA -> GGGAAGTCCCAACTTTGAAGATAA
TGGTAGATACAGACGGGAAGCCAT -> GGTAGATACAGACGGGAAGCCATA
TGGACTGTTGGCGTTGTACTCGTG -> GGACTGTTGGCGTTGTACTCGTGC
TGAGCCGGACCTTTTGTACAGTTC -> GAGCCGGACCTTTTGTACAGTTCG
AGTTGGACTGTTGGCGTTGTACTC -> GTTGGACTGTTGGCGTTGTACTCG
TACCGCCGGCTCGATGCTCGTCCT -> ACCGCCGGCTCGATGCTCGTCCTC
GGAGGACCACTCGTCGTGCGCGCG -> GAGGACCACTCGTCGTGCGCGCGT
CCGATAACACAAACAGTGGCGGCC -> CGATAACACAAACAGTGGCGGCCT
ATGCCATCTATATAGTCAAATTTT -> TGCCATCTATATAGTCAAATTTTC
AGAGGAATCCACCAGCCTAGTGTT -> GAGGAATCCACCAGCCTAGTGTTC
ACTGGTGAGTGAATCGTCCGGCCG -> CTGGTGAGTGAATCGTCCGGCCGC
GTTTTGTAATTTTTATGCAACTAT -> TTTTGTAATTTTTATGCAACTATA
AGAGGAGATGTTGCCTAAACGTCG -> GAGGAGATGTTGCCTAAACGTCGT
AGGGCTACCCGTATCTCTGAGCCC -> GGGCTACCCGTATCTCTGAGCCCG
TGATGAGCTAAATAGCGAACTAAT -> GATGAGCTAAATAGCGAACTAATA
TTCGCCTGCCCGAGCAGAACGCTA -> TCGCCTGCCCGAGCAGAACGCTAC
CAAATTCATGGGGAAAGAGCGCAC -> AAATTCATGGGGAAAGAGCGCACC
CTGGTGGACGCTCCTCCGTGGAGG -> TGGTGGACGCTCCTCCGTGGAGGA
CTTTGAAGATAATCGTTTCGATGC -> TTTGAAGATAATCGTTTCGATGCC
CGCATCCGGCCGAAGTGTATGTCT -> GCATCCGGCCGAAGTGTATGTCTA
ATCCCGTATCCCAATAATTCCGAA -> TCCCGTATCCCAATAATTCCGAAG
TACTTAAGCTTCAAGTGCGATGCG -> ACTTAAGCTTCAAGTGCGATGCGT
TGTTCACCGCTTAGGTGTATAAAA -> GTTCACCGCTTAGGTGTATAAAAG
ATCATGCCATCTATATAGTCAAAT -> TCATGCCATCTATATAGTCAAATT
GACCTACAGCGCAGTAACGTGACA -> ACCTACAGCGCAGTAACGTGACAA
TCGCCGTTGGGAGCGATGACCTAC -> CGCCGTTGGGAGCGATGACCTACA
GCGGGAGCCGCATGCGCTACCCAT -> CGGGAGCCGCATGCGCTACCCATA
ATGCCTGCTGGATGACGCGTATAC -> TGCCTGCTGGATGACGCGTATACG
TAGAGGGGGGAGTCTACCCACTAG -> AGAGGGGGGAGTCTACCCACTAGT
TGGGTCCCGTCGGGCATAAATTCA -> GGGTCCCGTCGGGCATAAATTCAA
ATGCTCGGCGTACAGAGTCCCCCG -> TGCTCGGCGTACAGAGTCCCCCGC
CGTATCCCAATAATTCCGAAGACA -> GTATCCCAATAATTCCGAAGACAG
ACCAGGGCGGCAGCCCAGAATCCC -> CCAGGGCGGCAGCCCAGAATCCCG
GCTCGATGCTCGTCCTCATGGAGG -> CTCGATGCTCGTCCTCATGGAGGC
TGTACTTCACTAGTGGGACTGGTG -> GTACTTCACTAGTGGGACTGGTGA
AGGGGCTAGTCAGGGACATAGTTG -> GGGGCTAGTCAGGGACATAGTTGT
TGTACAGTTCGTTTAGTTAGAGGC -> GTACAGTTCGTTTAGTTAGAGGCC
AAGACAGGTAGTTGGACTGTTGGC -> AGACAGGTAGTTGGACTGTTGGCG
TAAATTTACCTTCACCTTAAGCCC -> AAATTTACCTTCACCTTAAGCCCG
TGAGGTTGGCCCTTCATTTAGCAA -> GAGGTTGGCCCTTCATTTAGCAAA
TCCATGGGTCCCGTCGGGCATAAA -> CCATGGGTCCCGTCGGGCATAAAT
AACTAATAAGCCCTTGTATAAACG -> ACTAATAAGCCCTTGTATAAACGG
CGTCGACTCTACCACACTGACCTA -> GTCGACTCTACCACACTGACCTAC
TAACCAGATGAGACAACAAAGAAT -> AACCAGATGAGACAACAAAGAATG
GCGTTGTACTCGTGCAGTCCTTTC -> CGTTGTACTCGTGCAGTCCTTTCA
GCAAGTTACATTGGTGTCATCGAA -> CAAGTTACATTGGTGTCATCGAAA
AAATTCATGGGGAAAGAGCGCACC -> AATTCATGGGGAAAGAGCGCACCA
CACGATACCCACTGAGAGCGTATG -> ACGATACCCACTGAGAGCGTATGA
TCGTGCAGTCCTTTCAGGACGCGT -> CGTGCAGTCCTTTCAGGACGCGTC
CGGCGGGAGCCGCATGCGCTACCC -> GGCGGGAGCCGCATGCGCTACCCA
CGTCTCACACTGGATCGCATCCGG -> GTCTCACACTGGATCGCATCCGGC
AAGCCCTTGTATAAACGGTGACCC -> AGCCCTTGTATAAACGGTGACCCC
CAGAGGAGCTGAGCGTCGACTCTA -> AGAGGAGCTGAGCGTCGACTCTAC
GAAGGTACGTAGAAAATACCAGGA -> AAGGTACGTAGAAAATACCAGGAC
AGAATCCCGTATCCCAATAATTCC -> GAATCCCGTATCCCAATAATTCCG
CCTGCTGGATGACGCGTATACGGG -> CTGCTGGATGACGCGTATACGGGT
AGCCCGTAATTATTCATCTACTCC -> GCCCGTAATTATTCATCTACTCCA
CCCTTGTATAAACGGTGACCCCCG -> CCTTGTATAAACGGTGACCCCCGG
CCGTTCACAAGCCACCGTTATTTC -> CGTTCACAAGCCACCGTTATTTCG
GGCTTTCACTATTAAACCCTTATC -> GCTTTCACTATTAAACCCTTATCC
CCTCGCCAGCACATCATATGTGTC -> CTCGCCAGCACATCATATGTGTCG
ATCTCGCCGTTGGGAGCGATGACC -> TCTCGCCGTTGGGAGCGATGACCT
GTCTACTAGCCAAAGTTCGCTTTT -> TCTACTAGCCAAAGTTCGCTTTTT
CCGTTTTGTAATTTTTATGCAACT -> CGTTTTGTAATTTTTATGCAACTA
TCGTGCGCGCGTACGCCACATCCT -> CGTGCGCGCGTACGCCACATCCTG
TTTTTGAGAGGAATCCACCAGCCT -> TTTTGAGAGGAATCCACCAGCCTA
AGAAAATACCAGGACAATTTGTGG -> GAAAATACCAGGACAATTTGTGGT
GTGGCTGCCGGATCCCCAACTGAT -> TGGCTGCCGGATCCCCAACTGATC
GGGGGAGTCTACCCACTAGTGTTT -> GGGGAGTCTACCCACTAGTGTTTA
ATGGTTCAGATGCACTCCCCTCGT -> TGGTTCAGATGCACTCCCCTCGTA
AAAATAACCAGATGAGACAACAAA -> AAATAACCAGATGAGACAACAAAG
ACTAGCCAAAGTTCGCTTTTTGAG -> CTAGCCAAAGTTCGCTTTTTGAGA
GTATAAAAGTCAGAGGAGCTGAGC -> TATAAAAGTCAGAGGAGCTGAGCG
AATCCCGTATCCCAATAATTCCGA -> ATCCCGTATCCCAATAATTCCGAA
AGCATTTCGCTGTTGTCCGATAAC -> GCATTTCGCTGTTGTCCGATAACA
TCCTCATGGAGGCCCCGCACCTTG -> CCTCATGGAGGCCCCGCACCTTGC
GCCCTTCATTTAGCAAATTCATGG -> CCCTTCATTTAGCAAATTCATGGG
TCGATGCTCGTCCTCATGGAGGCC -> CGATGCTCGTCCTCATGGAGGCCC
ACGCTCCTCCGTGGAGGACCACTC -> CGCTCCTCCGTGGAGGACCACTCG
AACAAAGAATGAACGCAGTGCCCT -> ACAAAGAATGAACGCAGTGCCCTA
GCTTTCACTATTAAACCCTTATCC -> CTTTCACTATTAAACCCTTATCCG
CGTGACAAGTTGGGTGGCTGCCGG -> GTGACAAGTTGGGTGGCTGCCGGA
CACTGACCTACGATATTTCGCACT -> ACTGACCTACGATATTTCGCACTA
TTAGCAAATTCATGGGGAAAGAGC -> TAGCAAATTCATGGGGAAAGAGCG
GTGAGTGAATCGTCCGGCCGCGTG -> TGAGTGAATCGTCCGGCCGCGTGC
GTTCGCCTGCCCGAGCAGAACGCT -> TTCGCCTGCCCGAGCAGAACGCTA
GGCTGGAGCCGTGGAGGAAAATAC -> GCTGGAGCCGTGGAGGAAAATACG
AGTGGGACTGGTGAGTGAATCGTC -> GTGGGACTGGTGAGTGAATCGTCC
TGTCTACTAGCCAAAGTTCGCTTT -> GTCTACTAGCCAAAGTTCGCTTTT
CCCGGAGGAGCATTTCGCTGTTGT -> CCGGAGGAGCATTTCGCTGTTGTC
CTCCGCGGCCGGGCCCAAAAGGTA -> TCCGCGGCCGGGCCCAAAAGGTAA
TGCTTACCGCCGGCTCGATGCTCG -> GCTTACCGCCGGCTCGATGCTCGT
TAGGGCTACCCGTATCTCTGAGCC -> AGGGCTACCCGTATCTCTGAGCCC
TATGTGTCGTGAAGAGGAGATGTT -> ATGTGTCGTGAAGAGGAGATGTTG
ACCTTTTGTACAGTTCGTTTAGTT -> CCTTTTGTACAGTTCGTTTAGTTA
GGGAGCCGCATGCGCTACCCATAA -> GGAGCCGCATGCGCTACCCATAAT
CGCGTACGCCACATCCTGTTCACC -> GCGTACGCCACATCCTGTTCACCG
GTACGTAGAAAATACCAGGACAAT -> TACGTAGAAAATACCAGGACAATT
CTCTGAGCCCGCCGTAGAGGCTTC -> TCTGAGCCCGCCGTAGAGGCTTCC
GCCCGAGCAGAACGCTACCAGTAA -> CCCGAGCAGAACGCTACCAGTAAG
CATATGTGTCGTGAAGAGGAGATG -> ATATGTGTCGTGAAGAGGAGATGT
CACTAGTGTTTAATAACCATTTTA -> ACTAGTGTTTAATAACCATTTTAT
ACGGGCAAGTTACATTGGTGTCAT -> CGGGCAAGTTACATTGGTGTCATC
CCGACGATCGGCCTTTATAAATTT -> CGACGATCGGCCTTTATAAATTTA
TGGATCGCATCCGGCCGAAGTGTA -> GGATCGCATCCGGCCGAAGTGTAT
CAGGGACATAGTTGTACTTCACTA -> AGGGACATAGTTGTACTTCACTAG
CTGCTGGATGACGCGTATACGGGT -> TGCTGGATGACGCGTATACGGGTA
GTCAGAGGAGCTGAGCGTCGACTC -> TCAGAGGAGCTGAGCGTCGACTCT
CCACCGTTATTTCGCGTTTCTCAG -> CACCGTTATTTCGCGTTTCTCAGT
GAGAAGCCCTATCGCCGTTTTGTA -> AGAAGCCCTATCGCCGTTTTGTAA
AACCCTTATCCGTTCACAAGCCAC -> ACCCTTATCCGTTCACAAGCCACC
AAATACCAGGACAATTTGTGGTCA -> AATACCAGGACAATTTGTGGTCAA
CATGGAACGGGATTCCTTGGCTTT -> ATGGAACGGGATTCCTTGGCTTTG
CAGCCCAGAATCCCGTATCCCAAT -> AGCCCAGAATCCCGTATCCCAATA
CCAGCACATCATATGTGTCGTGAA -> CAGCACATCATATGTGTCGTGAAG
TTTACCTTCACCTTAAGCCCGTAA -> TTACCTTCACCTTAAGCCCGTAAT
CCGGACCTTTTGTACAGTTCGTTT -> CGGACCTTTTGTACAGTTCGTTTA
TATTCATCTACTCCACCGCAGTAC -> ATTCATCTACTCCACCGCAGTACG
GTAATGCCTGCTGGATGACGCGTA -> TAATGCCTGCTGGATGACGCGTAT
AATTTGTGGTCAACAGGCGAACTG -> ATTTGTGGTCAACAGGCGAACTGC
GCCCAAAAGGTAATGGTTCAGATG -> CCCAAAAGGTAATGGTTCAGATGC
CCAGGTCCTTCTAAGCGTTCCATG -> CAGGTCCTTCTAAGCGTTCCATGG
CCGCGGCACTGAGGCAGTAGTGGT -> CGCGGCACTGAGGCAGTAGTGGTA
CACCGCTTAGGTGTATAAAAGTCA -> ACCGCTTAGGTGTATAAAAGTCAG
TACGTGCATAGGTCGTCTTGACCT -> ACGTGCATAGGTCGTCTTGACCTG
CGGCCGGGCCCAAAAGGTAATGGT -> GGCCGGGCCCAAAAGGTAATGGTT
CGCAGTACGTGCATAGGTCGTCTT -> GCAGTACGTGCATAGGTCGTCTTG
GATGCGTGGATCATGCCATCTATA -> ATGCGTGGATCATGCCATCTATAT
CGCATGCGACAGCAATGATGAGCT -> GCATGCGACAGCAATGATGAGCTA
ACCCTTATCCGTTCACAAGCCACC -> CCCTTATCCGTTCACAAGCCACCG
GGCAAACCTACCGATTCTGTTAAG -> GCAAACCTACCGATTCTGTTAAGG
GGCTACCCGTATCTCTGAGCCCGC -> GCTACCCGTATCTCTGAGCCCGCC
AAGCCCTATCGCCGTTTTGTAATT -> AGCCCTATCGCCGTTTTGTAATTT
CTGCAGGAAAATAACCAGATGAGA -> TGCAGGAAAATAACCAGATGAGAC
CGTCTTGACCTGGGCAAACCTACC -> GTCTTGACCTGGGCAAACCTACCG
TAGTGCGCCGACGTAATGCCTGCT -> AGTGCGCCGACGTAATGCCTGCTG
TAGAGTTGGCCACCCAGGATTGGC -> AGAGTTGGCCACCCAGGATTGGCG
TTGAAGATAATCGTTTCGATGCCC -> TGAAGATAATCGTTTCGATGCCCC
AGTACGTGCATAGGTCGTCTTGAC -> GTACGTGCATAGGTCGTCTTGACC
CGAATGAGGGGCTAGTCAGGGACA -> GAATGAGGGGCTAGTCAGGGACAT
GGAAAATAACCAGATGAGACAACA -> GAAAATAACCAGATGAGACAACAA
TGGAGGCCCCGCACCTTGCACACA -> GGAGGCCCCGCACCTTGCACACAC
TGGATCATGCCATCTATATAGTCA -> GGATCATGCCATCTATATAGTCAA
GTGGTATGCTTACCGCCGGCTCGA -> TGGTATGCTTACCGCCGGCTCGAT
TACCAGTAAGGAACACCGTTATGA -> ACCAGTAAGGAACACCGTTATGAC
GCGTCGACTCTACCACACTGACCT -> CGTCGACTCTACCACACTGACCTA
ATTACCAGAGCACAAGCCGACGAT -> TTACCAGAGCACAAGCCGACGATC
CCTTGTATAAACGGTGACCCCCGG -> CTTGTATAAACGGTGACCCCCGGA
TCGCACTACCACGGGCAAGTTACA -> CGCACTACCACGGGCAAGTTACAT
TTTGGCGTTCCGACTGGCTGGAGC -> TTGGCGTTCCGACTGGCTGGAGCC
GCCAAAGTTCGCTTTTTGAGAGGA -> CCAAAGTTCGCTTTTTGAGAGGAA
GGCCAGCTCCGCGGCCGGGCCCAA -> GCCAGCTCCGCGGCCGGGCCCAAA
CAGTGCCCTACCCCCAGGTCCTTC -> AGTGCCCTACCCCCAGGTCCTTCT
CCTAGTGTTCGCCTGCCCGAGCAG -> CTAGTGTTCGCCTGCCCGAGCAGA
ATAGTGCGCCGACGTAATGCCTGC -> TAGTGCGCCGACGTAATGCCTGCT
GTCTAGAGGGGGGAGTCTACCCAC -> TCTAGAGGGGGGAGTCTACCCACT
GATTCTGTTAAGGCGTCATCCTGT -> ATTCTGTTAAGGCGTCATCCTGTA
CACTCGTCGTGCGCGCGTACGCCA -> ACTCGTCGTGCGCGCGTACGCCAC
AAGTCCCAACTTTGAAGATAATCG -> AGTCCCAACTTTGAAGATAATCGT
GTCGGAAGGTACGTAGAAAATACC -> TCGGAAGGTACGTAGAAAATACCA
CCGTGGAGGACCACTCGTCGTGCG -> CGTGGAGGACCACTCGTCGTGCGC
TGCACTCCCCTCGTACTTTGGTAG -> GCACTCCCCTCGTACTTTGGTAGA
CGGAAGGTACGTAGAAAATACCAG -> GGAAGGTACGTAGAAAATACCAGG
GGGGGGAGTCTACCCACTAGTGTT -> GGGGGAGTCTACCCACTAGTGTTT
GTCCCCCGCGGCACTGAGGCAGTA -> TCCCCCGCGGCACTGAGGCAGTAG
CGATCGGCCTTTATAAATTTACCT -> GATCGGCCTTTATAAATTTACCTT
GGACTGTTGGCGTTGTACTCGTGC -> GACTGTTGGCGTTGTACTCGTGCA
CTGCCGGATCCCCAACTGATCGGC -> TGCCGGATCCCCAACTGATCGGCT
AGGGACATAGTTGTACTTCACTAG -> GGGACATAGTTGTACTTCACTAGT
ACATCCTGTTCACCGCTTAGGTGT -> CATCCTGTTCACCGCTTAGGTGTA
CAATAATTCCGAAGACAGGTAGTT -> AATAATTCCGAAGACAGGTAGTTG
TCGGCCTTTATAAATTTACCTTCA -> CGGCCTTTATAAATTTACCTTCAC
AATACGGCACTTGGGAAGTCCCAA -> ATACGGCACTTGGGAAGTCCCAAC
AACTGCCTCGCCAGCACATCATAT -> ACTGCCTCGCCAGCACATCATATG
TTGGTAGATACAGACGGGAAGCCA -> TGGTAGATACAGACGGGAAGCCAT
AGCCGACGATCGGCCTTTATAAAT -> GCCGACGATCGGCCTTTATAAATT
TGACTGTTTTTGCCGCATGCGACA -> GACTGTTTTTGCCGCATGCGACAG
TTTGAGAGGAATCCACCAGCCTAG -> TTGAGAGGAATCCACCAGCCTAGT
CGTGCATAGGTCGTCTTGACCTGG -> GTGCATAGGTCGTCTTGACCTGGG
ACAAACAGTGGCGGCCTCTTTAGA -> CAAACAGTGGCGGCCTCTTTAGAG
AAATTTTCTCACTTTTGTGAAGGT -> AATTTTCTCACTTTTGTGAAGGTC
GATCATGCCATCTATATAGTCAAA -> ATCATGCCATCTATATAGTCAAAT
GAGGCCAGCTCCGCGGCCGGGCCC -> AGGCCAGCTCCGCGGCCGGGCCCA
CTACAGCGCAGTAACGTGACAAGT -> TACAGCGCAGTAACGTGACAAGTT
GCTCCGCGGCCGGGCCCAAAAGGT -> CTCCGCGGCCGGGCCCAAAAGGTA
TAAACGGTGACCCCCGGAGGAGCA -> AAACGGTGACCCCCGGAGGAGCAT
TAAATTCAACTGCCTCGCCAGCAC -> AAATTCAACTGCCTCGCCAGCACA
GGCTACATGGAACGGGATTCCTTG -> GCTACATGGAACGGGATTCCTTGG
CGGCCGAAGTGTATGTCTAGAGGG -> GGCCGAAGTGTATGTCTAGAGGGG
AGCCACCGTTATTTCGCGTTTCTC -> GCCACCGTTATTTCGCGTTTCTCA
GGTCAACAGGCGAACTGCAGGAAA -> GTCAACAGGCGAACTGCAGGAAAA
CATGGGTCCCGTCGGGCATAAATT -> ATGGGTCCCGTCGGGCATAAATTC
ATTGATGCGGCTACATGGAACGGG -> TTGATGCGGCTACATGGAACGGGA
AGAGTCCCCCGCGGCACTGAGGCA -> GAGTCCCCCGCGGCACTGAGGCAG
CGCTTTTTGAGAGGAATCCACCAG -> GCTTTTTGAGAGGAATCCACCAGC
TTGTGAAGGTCTCGTCTCACACTG -> TGTGAAGGTCTCGTCTCACACTGG
AGGTCTCGTCTCACACTGGATCGC -> GGTCTCGTCTCACACTGGATCGCA
CCTCATGGAGGCCCCGCACCTTGC -> CTCATGGAGGCCCCGCACCTTGCA
CCATAGTCGGCGGGAGCCGCATGC -> CATAGTCGGCGGGAGCCGCATGCG
CCCGAGCAGAACGCTACCAGTAAG -> CCGAGCAGAACGCTACCAGTAAGG
GTATGTTGAACCGGACATCTACAA -> TATGTTGAACCGGACATCTACAAC
AGTAGTGGTATGCTTACCGCCGGC -> GTAGTGGTATGCTTACCGCCGGCT
ACTGCCTCGCCAGCACATCATATG -> CTGCCTCGCCAGCACATCATATGT
AGCCCAGAATCCCGTATCCCAATA -> GCCCAGAATCCCGTATCCCAATAA
ATAGTCAAATTTTCTCACTTTTGT -> TAGTCAAATTTTCTCACTTTTGTG
GTATAAACGGTGACCCCCGGAGGA -> TATAAACGGTGACCCCCGGAGGAG
CTTCTAACGACTGAGGTTGGCCCT -> TTCTAACGACTGAGGTTGGCCCTT
TCCACCGCAGTACGTGCATAGGTC -> CCACCGCAGTACGTGCATAGGTCG
GTCGTCGGAAGACAGACTTGCTCC -> TCGTCGGAAGACAGACTTGCTCCA
CACTTTTGTGAAGGTCTCGTCTCA -> ACTTTTGTGAAGGTCTCGTCTCAC
GGATTGGCGCATACACGATCTGGT -> GATTGGCGCATACACGATCTGGTC
ATATTTTCTACAATTTGGAGTCAT -> TATTTTCTACAATTTGGAGTCATG
CTTTTTGAGAGGAATCCACCAGCC -> TTTTTGAGAGGAATCCACCAGCCT
CTGCCCGAGCAGAACGCTACCAGT -> TGCCCGAGCAGAACGCTACCAGTA
ACCTTAAGCCCGTAATTATTCATC -> CCTTAAGCCCGTAATTATTCATCT
CCTGTAGGTCGAATGAGGGGCTAG -> CTGTAGGTCGAATGAGGGGCTAGT
GCCCTACCCCCAGGTCCTTCTAAG -> CCCTACCCCCAGGTCCTTCTAAGC
TAATTATTCATCTACTCCACCGCA -> AATTATTCATCTACTCCACCGCAG
TTATTTCGCGTTTCTCAGTGTTGA -> TATTTCGCGTTTCTCAGTGTTGAT
TGTTGTCCGATAACACAAACAGTG -> GTTGTCCGATAACACAAACAGTGG
TACAGACGGGAAGCCATAGTCGGC -> ACAGACGGGAAGCCATAGTCGGCG
TCGTTTAGTTAGAGGCCAGCTCCG -> CGTTTAGTTAGAGGCCAGCTCCGC
TAATTACCAGAGCACAAGCCGACG -> AATTACCAGAGCACAAGCCGACGA
TACGGCACTTGGGAAGTCCCAACT -> ACGGCACTTGGGAAGTCCCAACTT
TACTCCACCGCAGTACGTGCATAG -> ACTCCACCGCAGTACGTGCATAGG
CTGTTCACCGCTTAGGTGTATAAA -> TGTTCACCGCTTAGGTGTATAAAA
AGGCTTCCAGCTTGAGGATTTAGG -> GGCTTCCAGCTTGAGGATTTAGGG
GTCTCGTCTCACACTGGATCGCAT -> TCTCGTCTCACACTGGATCGCATC
ACCCCCAGGTCCTTCTAAGCGTTC -> CCCCCAGGTCCTTCTAAGCGTTCC
ATAAGCCCTTGTATAAACGGTGAC -> TAAGCCCTTGTATAAACGGTGACC
GCCCGTAATTATTCATCTACTCCA -> CCCGTAATTATTCATCTACTCCAC
GCGCAGTAACGTGACAAGTTGGGT -> CGCAGTAACGTGACAAGTTGGGTG
GTCTTACTTAAGCTTCAAGTGCGA -> TCTTACTTAAGCTTCAAGTGCGAT
GATACCCACTGAGAGCGTATGACT -> ATACCCACTGAGAGCGTATGACTG
CCAGATGAGACAACAAAGAATGAA -> CAGATGAGACAACAAAGAATGAAC
GCATACACGATCTGGTCTTCTGGT -> CATACACGATCTGGTCTTCTGGTG
TCCGCGGCCGGGCCCAAAAGGTAA -> CCGCGGCCGGGCCCAAAAGGTAAT
TGACCTACAGCGCAGTAACGTGAC -> GACCTACAGCGCAGTAACGTGACA
TTACCGCCGGCTCGATGCTCGTCC -> TACCGCCGGCTCGATGCTCGTCCT
GACCGCCATAAGTCCTTCTAACGA -> ACCGCCATAAGTCCTTCTAACGAC
TCATGGAGGCCCCGCACCTTGCAC -> CATGGAGGCCCCGCACCTTGCACA
GTGCCCTACCCCCAGGTCCTTCTA -> TGCCCTACCCCCAGGTCCTTCTAA
CTTTGGCGTTCCGACTGGCTGGAG -> TTTGGCGTTCCGACTGGCTGGAGC
TCGCTGTTGTCCGATAACACAAAC -> CGCTGTTGTCCGATAACACAAACA
TCAGATGCACTCCCCTCGTACTTT -> CAGATGCACTCCCCTCGTACTTTG
GTTGATTGATGCGGCTACATGGAA -> TTGATTGATGCGGCTACATGGAAC
AGTCCTTCTAACGACTGAGGTTGG -> GTCCTTCTAACGACTGAGGTTGGC
CCAATAATTCCGAAGACAGGTAGT -> CAATAATTCCGAAGACAGGTAGTT
TAAGCCCTTGTATAAACGGTGACC -> AAGCCCTTGTATAAACGGTGACCC
TCACAAGCCACCGTTATTTCGCGT -> CACAAGCCACCGTTATTTCGCGTT
TCTTACTTAAGCTTCAAGTGCGAT -> CTTACTTAAGCTTCAAGTGCGATG
ATGAGACAACAAAGAATGAACGCA -> TGAGACAACAAAGAATGAACGCAG
TTCCTTGGCTTTGTCTACTAGCCA -> TCCTTGGCTTTGTCTACTAGCCAA
AGCAAATTCATGGGGAAAGAGCGC -> GCAAATTCATGGGGAAAGAGCGCA
GGTCCCGTCGGGCATAAATTCAAC -> GTCCCGTCGGGCATAAATTCAACT
CGTACTTTGGTAGATACAGACGGG -> GTACTTTGGTAGATACAGACGGGA
CAAACAGTGGCGGCCTCTTTAGAG -> AAACAGTGGCGGCCTCTTTAGAGT
CGCGTATACGGGTATCTAATTACC -> GCGTATACGGGTATCTAATTACCA
CTCACACTGGATCGCATCCGGCCG -> TCACACTGGATCGCATCCGGCCGA
AGTCCTTTCAGGACGCGTCGGAAG -> GTCCTTTCAGGACGCGTCGGAAGG
ATGCGTGGATCATGCCATCTATAT -> TGCGTGGATCATGCCATCTATATA
TGTACTCGTGCAGTCCTTTCAGGA -> GTACTCGTGCAGTCCTTTCAGGAC
CCGCCATAAGTCCTTCTAACGACT -> CGCCATAAGTCCTTCTAACGACTG
TTTGTCTACTAGCCAAAGTTCGCT -> TTGTCTACTAGCCAAAGTTCGCTT
TTTCACTATTAAACCCTTATCCGT -> TTCACTATTAAACCCTTATCCGTT
TACCAGAGCACAAGCCGACGATCG -> ACCAGAGCACAAGCCGACGATCGG
CATGCGACAGCAATGATGAGCTAA -> ATGCGACAGCAATGATGAGCTAAA
TCCCCTCGTACTTTGGTAGATACA -> CCCCTCGTACTTTGGTAGATACAG
ACATCATATGTGTCGTGAAGAGGA -> CATCATATGTGTCGTGAAGAGGAG
ACCGGACATCTACAACATCTCGCC -> CCGGACATCTACAACATCTCGCCG
TCATGAGCCGGACCTTTTGTACAG -> CATGAGCCGGACCTTTTGTACAGT
TTATGTTGTAATTCAACGGGAACA -> TATGTTGTAATTCAACGGGAACAA
GGCTGCCGGATCCCCAACTGATCG -> GCTGCCGGATCCCCAACTGATCGG
TAATTTTTATGCAACTATAGTGCG -> AATTTTTATGCAACTATAGTGCGC
ACTCGTGCAGTCCTTTCAGGACGC -> CTCGTGCAGTCCTTTCAGGACGCG
CCTTGGCTTTGTCTACTAGCCAAA -> CTTGGCTTTGTCTACTAGCCAAAG
ATGCGACAGCAATGATGAGCTAAA -> TGCGACAGCAATGATGAGCTAAAT
TTAGAGGCCAGCTCCGCGGCCGGG -> TAGAGGCCAGCTCCGCGGCCGGGC
CCCCTGTCTTACTTAAGCTTCAAG -> CCCTGTCTTACTTAAGCTTCAAGT
TATCGCCGTTTTGTAATTTTTATG -> ATCGCCGTTTTGTAATTTTTATGC
GCCGGCTCGATGCTCGTCCTCATG -> CCGGCTCGATGCTCGTCCTCATGG
CCCAAAAGGTAATGGTTCAGATGC -> CCAAAAGGTAATGGTTCAGATGCA
GTAATGGTTCAGATGCACTCCCCT -> TAATGGTTCAGATGCACTCCCCTC
AGCACAAGCCGACGATCGGCCTTT -> GCACAAGCCGACGATCGGCCTTTA
CGCTACCAGTAAGGAACACCGTTA -> GCTACCAGTAAGGAACACCGTTAT
TTAAGCTTCAAGTGCGATGCGTGG -> TAAGCTTCAAGTGCGATGCGTGGA
AAAAGGTAATGGTTCAGATGCACT -> AAAGGTAATGGTTCAGATGCACTC
GACCACTCGTCGTGCGCGCGTACG -> ACCACTCGTCGTGCGCGCGTACGC
TGGAGTCATGAGCCGGACCTTTTG -> GGAGTCATGAGCCGGACCTTTTGT
CTGTCTTACTTAAGCTTCAAGTGC -> TGTCTTACTTAAGCTTCAAGTGCG
GATGTTGCCTAAACGTCGTCGGAA -> ATGTTGCCTAAACGTCGTCGGAAG
CCGCATGCGACAGCAATGATGAGC -> CGCATGCGACAGCAATGATGAGCT
TGGGTGGCTGCCGGATCCCCAACT -> GGGTGGCTGCCGGATCCCCAACTG
TTGGGAGCGATGACCTACAGCGCA -> TGGGAGCGATGACCTACAGCGCAG
TCTCACTTTTGTGAAGGTCTCGTC -> CTCACTTTTGTGAAGGTCTCGTCT
ACCTACAGCGCAGTAACGTGACAA -> CCTACAGCGCAGTAACGTGACAAG
GTTTAATAACCATTTTATGTTGTA -> TTTAATAACCATTTTATGTTGTAA
CATTTCGCTGTTGTCCGATAACAC -> ATTTCGCTGTTGTCCGATAACACA
ACTACCACGGGCAAGTTACATTGG -> CTACCACGGGCAAGTTACATTGGT
AGTCAAATTTTCTCACTTTTGTGA -> GTCAAATTTTCTCACTTTTGTGAA
TAACACAAACAGTGGCGGCCTCTT -> AACACAAACAGTGGCGGCCTCTTT
TAGTCAAATTTTCTCACTTTTGTG -> AGTCAAATTTTCTCACTTTTGTGA
TTGCCGCATGCGACAGCAATGATG -> TGCCGCATGCGACAGCAATGATGA
CAGAATCCCGTATCCCAATAATTC -> AGAATCCCGTATCCCAATAATTCC
CGTAATTATTCATCTACTCCACCG -> GTAATTATTCATCTACTCCACCGC
GACTGTTTTTGCCGCATGCGACAG -> ACTGTTTTTGCCGCATGCGACAGC
CAACATCTCGCCGTTGGGAGCGAT -> AACATCTCGCCGTTGGGAGCGATG
ATATGTGTCGTGAAGAGGAGATGT -> TATGTGTCGTGAAGAGGAGATGTT
GTCAACAGGCGAACTGCAGGAAAA -> TCAACAGGCGAACTGCAGGAAAAT
GTAATTCAACGGGAACAACCAGGG -> TAATTCAACGGGAACAACCAGGGC
GCTCCTCCGTGGAGGACCACTCGT -> CTCCTCCGTGGAGGACCACTCGTC
AGTCATGAGCCGGACCTTTTGTAC -> GTCATGAGCCGGACCTTTTGTACA
TACCACACTGACCTACGATATTTC -> ACCACACTGACCTACGATATTTCG
TCTCTGAGCCCGCCGTAGAGGCTT -> CTCTGAGCCCGCCGTAGAGGCTTC
CCGAAGACAGGTAGTTGGACTGTT -> CGAAGACAGGTAGTTGGACTGTTG
AATCCACCAGCCTAGTGTTCGCCT -> ATCCACCAGCCTAGTGTTCGCCTG
TGACCTACGATATTTCGCACTACC -> GACCTACGATATTTCGCACTACCA
ACTGGATCGCATCCGGCCGAAGTG -> CTGGATCGCATCCGGCCGAAGTGT
CGGGAGCCGCATGCGCTACCCATA -> GGGAGCCGCATGCGCTACCCATAA
ATGCACTCCCCTCGTACTTTGGTA -> TGCACTCCCCTCGTACTTTGGTAG
TGGGACTGGTGAGTGAATCGTCCG -> GGGACTGGTGAGTGAATCGTCCGG
CTTTGGTAGATACAGACGGGAAGC -> TTTGGTAGATACAGACGGGAAGCC
AGAGGGGGGAGTCTACCCACTAGT -> GAGGGGGGAGTCTACCCACTAGTG
GCACCTTGCACACACTAGGGCTAC -> CACCTTGCACACACTAGGGCTACC
GCCCGCCGTAGAGGCTTCCAGCTT -> CCCGCCGTAGAGGCTTCCAGCTTG
CAGCAATGATGAGCTAAATAGCGA -> AGCAATGATGAGCTAAATAGCGAA
CCGCCGGCTCGATGCTCGTCCTCA -> CGCCGGCTCGATGCTCGTCCTCAT
TACCCCCAGGTCCTTCTAAGCGTT -> ACCCCCAGGTCCTTCTAAGCGTTC
CACCGTTATGACCGCCATAAGTCC -> ACCGTTATGACCGCCATAAGTCCT
CCTGTTCACCGCTTAGGTGTATAA -> CTGTTCACCGCTTAGGTGTATAAA
GGAGATGTTGCCTAAACGTCGTCG -> GAGATGTTGCCTAAACGTCGTCGG
GAGTCTACCCACTAGTGTTTAATA -> AGTCTACCCACTAGTGTTTAATAA
AGCGTCGACTCTACCACACTGACC -> GCGTCGACTCTACCACACTGACCT
GTACGTGCATAGGTCGTCTTGACC -> TACGTGCATAGGTCGTCTTGACCT
TGCGTGGATCATGCCATCTATATA -> GCGTGGATCATGCCATCTATATAG
GAAGACAGGTAGTTGGACTGTTGG -> AAGACAGGTAGTTGGACTGTTGGC
GCTTGAGGATTTAGGGCTTTCACT -> CTTGAGGATTTAGGGCTTTCACTA
ACACACTAGGGCTACCCGTATCTC -> CACACTAGGGCTACCCGTATCTCT
GTACTCGTGCAGTCCTTTCAGGAC -> TACTCGTGCAGTCCTTTCAGGACG
CGTAGAGGCTTCCAGCTTGAGGAT -> GTAGAGGCTTCCAGCTTGAGGATT
AGCGTTCCATGGGTCCCGTCGGGC -> GCGTTCCATGGGTCCCGTCGGGCA
AGGTAATGGTTCAGATGCACTCCC -> GGTAATGGTTCAGATGCACTCCCC
TCAACAGGCGAACTGCAGGAAAAT -> CAACAGGCGAACTGCAGGAAAATA
GGCCGGGCCCAAAAGGTAATGGTT -> GCCGGGCCCAAAAGGTAATGGTTC
CTTCACCTTAAGCCCGTAATTATT -> TTCACCTTAAGCCCGTAATTATTC
CTTGAGGATTTAGGGCTTTCACTA -> TTGAGGATTTAGGGCTTTCACTAT
GTTGTCCGATAACACAAACAGTGG -> TTGTCCGATAACACAAACAGTGGC
GAACGCAGTGCCCTACCCCCAGGT -> AACGCAGTGCCCTACCCCCAGGTC
CACTAGTGGGACTGGTGAGTGAAT -> ACTAGTGGGACTGGTGAGTGAATC
AAGCTTCAAGTGCGATGCGTGGAT -> AGCTTCAAGTGCGATGCGTGGATC
CTACATGGAACGGGATTCCTTGGC -> TACATGGAACGGGATTCCTTGGCT
AGGTAGTTGGACTGTTGGCGTTGT -> GGTAGTTGGACTGTTGGCGTTGTA
GAGGGGCTAGTCAGGGACATAGTT -> AGGGGCTAGTCAGGGACATAGTTG
AGGACCACTCGTCGTGCGCGCGTA -> GGACCACTCGTCGTGCGCGCGTAC
ACGGGAACAACCAGGGCGGCAGCC -> CGGGAACAACCAGGGCGGCAGCCC
GTAGTGGTATGCTTACCGCCGGCT -> TAGTGGTATGCTTACCGCCGGCTC
CTATATAGTCAAATTTTCTCACTT -> TATATAGTCAAATTTTCTCACTTT
TTTCTCAGTGTTGATTGATGCGGC -> TTCTCAGTGTTGATTGATGCGGCT
GGGCAAACCTACCGATTCTGTTAA -> GGCAAACCTACCGATTCTGTTAAG
TCACTATTAAACCCTTATCCGTTC -> CACTATTAAACCCTTATCCGTTCA
ACCTGGGCAAACCTACCGATTCTG -> CCTGGGCAAACCTACCGATTCTGT
ACAGCGCAGTAACGTGACAAGTTG -> CAGCGCAGTAACGTGACAAGTTGG
TTATCCGTTCACAAGCCACCGTTA -> TATCCGTTCACAAGCCACCGTTAT
GGCAAGTTACATTGGTGTCATCGA -> GCAAGTTACATTGGTGTCATCGAA
AGGAAAATACGGCACTTGGGAAGT -> GGAAAATACGGCACTTGGGAAGTC
CCCTCGTACTTTGGTAGATACAGA -> CCTCGTACTTTGGTAGATACAGAC
ATTTGGAGTCATGAGCCGGACCTT -> TTTGGAGTCATGAGCCGGACCTTT
GCCGGATCCCCAACTGATCGGCTT -> CCGGATCCCCAACTGATCGGCTTC
AAGCCCGTAATTATTCATCTACTC -> AGCCCGTAATTATTCATCTACTCC
CGTTTCTCAGTGTTGATTGATGCG -> GTTTCTCAGTGTTGATTGATGCGG
TATGACCGCCATAAGTCCTTCTAA -> ATGACCGCCATAAGTCCTTCTAAC
GCGCGTACGCCACATCCTGTTCAC -> CGCGTACGCCACATCCTGTTCACC
ACTATTAAACCCTTATCCGTTCAC -> CTATTAAACCCTTATCCGTTCACA
GCAACTATAGTGCGCCGACGTAAT -> CAACTATAGTGCGCCGACGTAATG
AGTGGCGGCCTCTTTAGAGTTGGC -> GTGGCGGCCTCTTTAGAGTTGGCC
GAACGGGATTCCTTGGCTTTGTCT -> AACGGGATTCCTTGGCTTTGTCTA
TGAAGGTCTCGTCTCACACTGGAT -> GAAGGTCTCGTCTCACACTGGATC
CCATCTATATAGTCAAATTTTCTC -> CATCTATATAGTCAAATTTTCTCA
TCTTGACCTGGGCAAACCTACCGA -> CTTGACCTGGGCAAACCTACCGAT
CGTGGATCATGCCATCTATATAGT -> GTGGATCATGCCATCTATATAGTC
GCCCCCCCCATGCTCGGCGTACAG -> CCCCCCCCATGCTCGGCGTACAGA
TATGTTGAACCGGACATCTACAAC -> ATGTTGAACCGGACATCTACAACA
CCTGGGCAAACCTACCGATTCTGT -> CTGGGCAAACCTACCGATTCTGTT
AACGGGAACAACCAGGGCGGCAGC -> ACGGGAACAACCAGGGCGGCAGCC
AGGTGTATAAAAGTCAGAGGAGCT -> GGTGTATAAAAGTCAGAGGAGCTG
GCTCGTCCTCATGGAGGCCCCGCA -> CTCGTCCTCATGGAGGCCCCGCAC
CGCCACATCCTGTTCACCGCTTAG -> GCCACATCCTGTTCACCGCTTAGG
CTAAACGTCGTCGGAAGACAGACT -> TAAACGTCGTCGGAAGACAGACTT
TCCTTTCAGGACGCGTCGGAAGGT -> CCTTTCAGGACGCGTCGGAAGGTA
ATACGGGTATCTAATTACCAGAGC -> TACGGGTATCTAATTACCAGAGCA
CCAAAGTTCGCTTTTTGAGAGGAA -> CAAAGTTCGCTTTTTGAGAGGAAT
GTCGACTCTACCACACTGACCTAC -> TCGACTCTACCACACTGACCTACG
CGGCCTTTATAAATTTACCTTCAC -> GGCCTTTATAAATTTACCTTCACC
TTCCGACTGGCTGGAGCCGTGGAG -> TCCGACTGGCTGGAGCCGTGGAGG
TTTATGCAACTATAGTGCGCCGAC -> TTATGCAACTATAGTGCGCCGACG
CCCTATCGCCGTTTTGTAATTTTT -> CCTATCGCCGTTTTGTAATTTTTA
AGGCAGTAGTGGTATGCTTACCGC -> GGCAGTAGTGGTATGCTTACCGCC
CAGACGGGAAGCCATAGTCGGCGG -> AGACGGGAAGCCATAGTCGGCGGG
CGGATCCCCAACTGATCGGCTTCA -> GGATCCCCAACTGATCGGCTTCAC
GATGCTCGTCCTCATGGAGGCCCC -> ATGCTCGTCCTCATGGAGGCCCCG
TGTGTCGTGAAGAGGAGATGTTGC -> GTGTCGTGAAGAGGAGATGTTGCC
GCGTCATCCTGTAGGTCGAATGAG -> CGTCATCCTGTAGGTCGAATGAGG
TAGAGAAGCCCTATCGCCGTTTTG -> AGAGAAGCCCTATCGCCGTTTTGT
GATAATCGTTTCGATGCCCCTACG -> ATAATCGTTTCGATGCCCCTACGC
GACTCTACCACACTGACCTACGAT -> ACTCTACCACACTGACCTACGATA
ACTCCACCGCAGTACGTGCATAGG -> CTCCACCGCAGTACGTGCATAGGT
AAGCCATAGTCGGCGGGAGCCGCA -> AGCCATAGTCGGCGGGAGCCGCAT
TAATGGTTCAGATGCACTCCCCTC -> AATGGTTCAGATGCACTCCCCTCG
TTTTATGCAACTATAGTGCGCCGA -> TTTATGCAACTATAGTGCGCCGAC
TCTGGTCTTCTGGTGGACGCTCCT -> CTGGTCTTCTGGTGGACGCTCCTC
CGAAGACAGGTAGTTGGACTGTTG -> GAAGACAGGTAGTTGGACTGTTGG
CTGGTCTTCTGGTGGACGCTCCTC -> TGGTCTTCTGGTGGACGCTCCTCC
CCGCGTGCACGATACCCACTGAGA -> CGCGTGCACGATACCCACTGAGAG
CGACTGAGGTTGGCCCTTCATTTA -> GACTGAGGTTGGCCCTTCATTTAG
TCTATATAGTCAAATTTTCTCACT -> CTATATAGTCAAATTTTCTCACTT
GAGCGTCGACTCTACCACACTGAC -> AGCGTCGACTCTACCACACTGACC
GGCATAAATTCAACTGCCTCGCCA -> GCATAAATTCAACTGCCTCGCCAG
ATCTACTCCACCGCAGTACGTGCA -> TCTACTCCACCGCAGTACGTGCAT
TCGATGCCCCTACGCAGGATATTT -> CGATGCCCCTACGCAGGATATTTT
AAGCGTTCCATGGGTCCCGTCGGG -> AGCGTTCCATGGGTCCCGTCGGGC
CTGGGCAAACCTACCGATTCTGTT -> TGGGCAAACCTACCGATTCTGTTA
TTCATCTACTCCACCGCAGTACGT -> TCATCTACTCCACCGCAGTACGTG
TAACGTGACAAGTTGGGTGGCTGC -> AACGTGACAAGTTGGGTGGCTGCC
TAGCGAACTAATAAGCCCTTGTAT -> AGCGAACTAATAAGCCCTTGTATA
CGGCTCGATGCTCGTCCTCATGGA -> GGCTCGATGCTCGTCCTCATGGAG
ACCAGTAAGGAACACCGTTATGAC -> CCAGTAAGGAACACCGTTATGACC
CGCCGGCTCGATGCTCGTCCTCAT -> GCCGGCTCGATGCTCGTCCTCATG
CCACCGCAGTACGTGCATAGGTCG -> CACCGCAGTACGTGCATAGGTCGT
TCGTTTCGATGCCCCTACGCAGGA -> CGTTTCGATGCCCCTACGCAGGAT
TAATAACCATTTTATGTTGTAATT -> AATAACCATTTTATGTTGTAATTC
TCGCCAGCACATCATATGTGTCGT -> CGCCAGCACATCATATGTGTCGTG
ACGGTGACCCCCGGAGGAGCATTT -> CGGTGACCCCCGGAGGAGCATTTC
TTCGCGTTTCTCAGTGTTGATTGA -> TCGCGTTTCTCAGTGTTGATTGAT
TCGACTCTACCACACTGACCTACG -> CGACTCTACCACACTGACCTACGA
TGATGCGGCTACATGGAACGGGAT -> GATGCGGCTACATGGAACGGGATT
CAGCTTGAGGATTTAGGGCTTTCA -> AGCTTGAGGATTTAGGGCTTTCAC
CACTACCACGGGCAAGTTACATTG -> ACTACCACGGGCAAGTTACATTGG
TTAGAGAAGCCCTATCGCCGTTTT -> TAGAGAAGCCCTATCGCCGTTTTG
GTGCATAGGTCGTCTTGACCTGGG -> TGCATAGGTCGTCTTGACCTGGGC
GTCGAATGAGGGGCTAGTCAGGGA -> TCGAATGAGGGGCTAGTCAGGGAC
CGGCGTACAGAGTCCCCCGCGGCA -> GGCGTACAGAGTCCCCCGCGGCAC
CATACACGATCTGGTCTTCTGGTG -> ATACACGATCTGGTCTTCTGGTGG
CCAGCCTAGTGTTCGCCTGCCCGA -> CAGCCTAGTGTTCGCCTGCCCGAG
TATTAAACCCTTATCCGTTCACAA -> ATTAAACCCTTATCCGTTCACAAG
AGGAGCATTTCGCTGTTGTCCGAT -> GGAGCATTTCGCTGTTGTCCGATA
AATTTACCTTCACCTTAAGCCCGT -> ATTTACCTTCACCTTAAGCCCGTA
ACTTTTGTGAAGGTCTCGTCTCAC -> CTTTTGTGAAGGTCTCGTCTCACA
GTAAGGAACACCGTTATGACCGCC -> TAAGGAACACCGTTATGACCGCCA
TGAGGGGCTAGTCAGGGACATAGT -> GAGGGGCTAGTCAGGGACATAGTT
GAAAATACCAGGACAATTTGTGGT -> AAAATACCAGGACAATTTGTGGTC
CAGGATATTTTCTACAATTTGGAG -> AGGATATTTTCTACAATTTGGAGT
TCACCGCTTAGGTGTATAAAAGTC -> CACCGCTTAGGTGTATAAAAGTCA
TGGTGAGTGAATCGTCCGGCCGCG -> GGTGAGTGAATCGTCCGGCCGCGT
GCACGATACCCACTGAGAGCGTAT -> CACGATACCCACTGAGAGCGTATG
GGAGCTGAGCGTCGACTCTACCAC -> GAGCTGAGCGTCGACTCTACCACA
CGTCCTCATGGAGGCCCCGCACCT -> GTCCTCATGGAGGCCCCGCACCTT
GCGAACTAATAAGCCCTTGTATAA -> CGAACTAATAAGCCCTTGTATAAA
ACAGCAATGATGAGCTAAATAGCG -> CAGCAATGATGAGCTAAATAGCGA
ACGTGACAAGTTGGGTGGCTGCCG -> CGTGACAAGTTGGGTGGCTGCCGG
TGTTGGCGTTGTACTCGTGCAGTC -> GTTGGCGTTGTACTCGTGCAGTCC
AAAATACGGCACTTGGGAAGTCCC -> AAATACGGCACTTGGGAAGTCCCA
CGTATGACTGTTTTTGCCGCATGC -> GTATGACTGTTTTTGCCGCATGCG
TATACGGGTATCTAATTACCAGAG -> ATACGGGTATCTAATTACCAGAGC
CTTCACTAGTGGGACTGGTGAGTG -> TTCACTAGTGGGACTGGTGAGTGA
GGCAGTAGTGGTATGCTTACCGCC -> GCAGTAGTGGTATGCTTACCGCCG
CCGTCGGGCATAAATTCAACTGCC -> CGTCGGGCATAAATTCAACTGCCT
GAAGAGGAGATGTTGCCTAAACGT -> AAGAGGAGATGTTGCCTAAACGTC
AGACTTGCTCCAGAGCATGAATGT -> GACTTGCTCCAGAGCATGAATGTA
CAGCGCAGTAACGTGACAAGTTGG -> AGCGCAGTAACGTGACAAGTTGGG
CGCACCTTGCACACACTAGGGCTA -> GCACCTTGCACACACTAGGGCTAC
GCAGAACGCTACCAGTAAGGAACA -> CAGAACGCTACCAGTAAGGAACAC
ACTGCAGGAAAATAACCAGATGAG -> CTGCAGGAAAATAACCAGATGAGA
GCTTTTTGAGAGGAATCCACCAGC -> CTTTTTGAGAGGAATCCACCAGCC
AATCGTCCGGCCGCGTGCACGATA -> ATCGTCCGGCCGCGTGCACGATAC
ATTAAACCCTTATCCGTTCACAAG -> TTAAACCCTTATCCGTTCACAAGC
CCCGTAATTATTCATCTACTCCAC -> CCGTAATTATTCATCTACTCCACC
GATTTAGGGCTTTCACTATTAAAC -> ATTTAGGGCTTTCACTATTAAACC
AATTCAACGGGAACAACCAGGGCG -> ATTCAACGGGAACAACCAGGGCGG
TCCGTGGAGGACCACTCGTCGTGC -> CCGTGGAGGACCACTCGTCGTGCG
ATCTACAACATCTCGCCGTTGGGA -> TCTACAACATCTCGCCGTTGGGAG
GGGCCCAAAAGGTAATGGTTCAGA -> GGCCCAAAAGGTAATGGTTCAGAT
CACACTGACCTACGATATTTCGCA -> ACACTGACCTACGATATTTCGCAC
AGGTCGAATGAGGGGCTAGTCAGG -> GGTCGAATGAGGGGCTAGTCAGGG
ATGGGGAAAGAGCGCACCATTAGA -> TGGGGAAAGAGCGCACCATTAGAG
CTGTTAAGGCGTCATCCTGTAGGT -> TGTTAAGGCGTCATCCTGTAGGTC
TCCGATAACACAAACAGTGGCGGC -> CCGATAACACAAACAGTGGCGGCC
ATCCCCAACTGATCGGCTTCACCG -> TCCCCAACTGATCGGCTTCACCGC
GCATAAATTCAACTGCCTCGCCAG -> CATAAATTCAACTGCCTCGCCAGC
ATTTCGCACTACCACGGGCAAGTT -> TTTCGCACTACCACGGGCAAGTTA
CCCACTGAGAGCGTATGACTGTTT -> CCACTGAGAGCGTATGACTGTTTT
ACGTAGAAAATACCAGGACAATTT -> CGTAGAAAATACCAGGACAATTTG
GGTCTCGTCTCACACTGGATCGCA -> GTCTCGTCTCACACTGGATCGCAT
TTTGGTAGATACAGACGGGAAGCC -> TTGGTAGATACAGACGGGAAGCCA
CCTTAAGCCCGTAATTATTCATCT -> CTTAAGCCCGTAATTATTCATCTA
CCCATGCTCGGCGTACAGAGTCCC -> CCATGCTCGGCGTACAGAGTCCCC
CCACTGAGAGCGTATGACTGTTTT -> CACTGAGAGCGTATGACTGTTTTT
CACCGTTATTTCGCGTTTCTCAGT -> ACCGTTATTTCGCGTTTCTCAGTG
AGACGGGAAGCCATAGTCGGCGGG -> GACGGGAAGCCATAGTCGGCGGGA
GTCGGCGGGAGCCGCATGCGCTAC -> TCGGCGGGAGCCGCATGCGCTACC
AGTTCGCTTTTTGAGAGGAATCCA -> GTTCGCTTTTTGAGAGGAATCCAC
GCGCTACCCATAATACACTGATTT -> CGCTACCCATAATACACTGATTTA
GACAGACTTGCTCCAGAGCATGAA -> ACAGACTTGCTCCAGAGCATGAAT
TGCCCCCCCCATGCTCGGCGTACA -> GCCCCCCCCATGCTCGGCGTACAG
ACACAAACAGTGGCGGCCTCTTTA -> CACAAACAGTGGCGGCCTCTTTAG
CCACGGGCAAGTTACATTGGTGTC -> CACGGGCAAGTTACATTGGTGTCA
TTGATTGATGCGGCTACATGGAAC -> TGATTGATGCGGCTACATGGAACG
GTGTTCGCCTGCCCGAGCAGAACG -> TGTTCGCCTGCCCGAGCAGAACGC
AGAGGCCAGCTCCGCGGCCGGGCC -> GAGGCCAGCTCCGCGGCCGGGCCC
CGCGTTTCTCAGTGTTGATTGATG -> GCGTTTCTCAGTGTTGATTGATGC
AAGTCAGAGGAGCTGAGCGTCGAC -> AGTCAGAGGAGCTGAGCGTCGACT
ATCCGGCCGAAGTGTATGTCTAGA -> TCCGGCCGAAGTGTATGTCTAGAG
TGCGGCTACATGGAACGGGATTCC -> GCGGCTACATGGAACGGGATTCCT
TGTATAAAAGTCAGAGGAGCTGAG -> GTATAAAAGTCAGAGGAGCTGAGC
CGTACGCCACATCCTGTTCACCGC -> GTACGCCACATCCTGTTCACCGCT
CCCCGCGGCACTGAGGCAGTAGTG -> CCCGCGGCACTGAGGCAGTAGTGG
AGATACAGACGGGAAGCCATAGTC -> GATACAGACGGGAAGCCATAGTCG
CTCGCCAGCACATCATATGTGTCG -> TCGCCAGCACATCATATGTGTCGT
CGATGACCTACAGCGCAGTAACGT -> GATGACCTACAGCGCAGTAACGTG
GAGCCGCATGCGCTACCCATAATA -> AGCCGCATGCGCTACCCATAATAC
TGGGGAAAGAGCGCACCATTAGAG -> GGGGAAAGAGCGCACCATTAGAGA
CTGCCCCCCCCATGCTCGGCGTAC -> TGCCCCCCCCATGCTCGGCGTACA
TATGTCTAGAGGGGGGAGTCTACC -> ATGTCTAGAGGGGGGAGTCTACCC
TTCTACAATTTGGAGTCATGAGCC -> TCTACAATTTGGAGTCATGAGCCG
GTGTATGTCTAGAGGGGGGAGTCT -> TGTATGTCTAGAGGGGGGAGTCTA
GGATATTTTCTACAATTTGGAGTC -> GATATTTTCTACAATTTGGAGTCA
ACTTAAGCTTCAAGTGCGATGCGT -> CTTAAGCTTCAAGTGCGATGCGTG
CATCTACAACATCTCGCCGTTGGG -> ATCTACAACATCTCGCCGTTGGGA
CGCGTGCACGATACCCACTGAGAG -> GCGTGCACGATACCCACTGAGAGC
AAACAGTGGCGGCCTCTTTAGAGT -> AACAGTGGCGGCCTCTTTAGAGTT
AGACAGGTAGTTGGACTGTTGGCG -> GACAGGTAGTTGGACTGTTGGCGT
AGGATTTAGGGCTTTCACTATTAA -> GGATTTAGGGCTTTCACTATTAAA
ATAATTCCGAAGACAGGTAGTTGG -> TAATTCCGAAGACAGGTAGTTGGA
CCCTTCATTTAGCAAATTCATGGG -> CCTTCATTTAGCAAATTCATGGGG
TCAACTGCCTCGCCAGCACATCAT -> CAACTGCCTCGCCAGCACATCATA
CCAGGGCGGCAGCCCAGAATCCCG -> CAGGGCGGCAGCCCAGAATCCCGT
TATAAACGGTGACCCCCGGAGGAG -> ATAAACGGTGACCCCCGGAGGAGC
TGCACACACTAGGGCTACCCGTAT -> GCACACACTAGGGCTACCCGTATC
GCGTATACGGGTATCTAATTACCA -> CGTATACGGGTATCTAATTACCAG
CGATAACACAAACAGTGGCGGCCT -> GATAACACAAACAGTGGCGGCCTC
TGGAGCCGTGGAGGAAAATACGGC -> GGAGCCGTGGAGGAAAATACGGCA
TTTAATAACCATTTTATGTTGTAA -> TTAATAACCATTTTATGTTGTAAT
GAAAGACTTTGGCGTTCCGACTGG -> AAAGACTTTGGCGTTCCGACTGGC
TCTAACGACTGAGGTTGGCCCTTC -> CTAACGACTGAGGTTGGCCCTTCA
CGCGTCGGAAGGTACGTAGAAAAT -> GCGTCGGAAGGTACGTAGAAAATA
TCCCGTCGGGCATAAATTCAACTG -> CCCGTCGGGCATAAATTCAACTGC
CCGTATCTCTGAGCCCGCCGTAGA -> CGTATCTCTGAGCCCGCCGTAGAG
GCGGCCGGGCCCAAAAGGTAATGG -> CGGCCGGGCCCAAAAGGTAATGGT
TATAAATTTACCTTCACCTTAAGC -> ATAAATTTACCTTCACCTTAAGCC
AGGAGCTGAGCGTCGACTCTACCA -> GGAGCTGAGCGTCGACTCTACCAC
GGCCACCCAGGATTGGCGCATACA -> GCCACCCAGGATTGGCGCATACAC
CGACGATCGGCCTTTATAAATTTA -> GACGATCGGCCTTTATAAATTTAC
CCGGAGGAGCATTTCGCTGTTGTC -> CGGAGGAGCATTTCGCTGTTGTCC
GCGTTCCGACTGGCTGGAGCCGTG -> CGTTCCGACTGGCTGGAGCCGTGG
CTGACCTACGATATTTCGCACTAC -> TGACCTACGATATTTCGCACTACC
TTCACCTTAAGCCCGTAATTATTC -> TCACCTTAAGCCCGTAATTATTCA
AGCGAACTAATAAGCCCTTGTATA -> GCGAACTAATAAGCCCTTGTATAA
GCGCACCATTAGAGAAGCCCTATC -> CGCACCATTAGAGAAGCCCTATCG
TGAATCGTCCGGCCGCGTGCACGA -> GAATCGTCCGGCCGCGTGCACGAT
CTTGCACACACTAGGGCTACCCGT -> TTGCACACACTAGGGCTACCCGTA
CCGCCGTAGAGGCTTCCAGCTTGA -> CGCCGTAGAGGCTTCCAGCTTGAG
GAGCCGTGGAGGAAAATACGGCAC -> AGCCGTGGAGGAAAATACGGCACT
CGTTCACAAGCCACCGTTATTTCG -> GTTCACAAGCCACCGTTATTTCGC
TTCAGGACGCGTCGGAAGGTACGT -> TCAGGACGCGTCGGAAGGTACGTA
CTACCCGTATCTCTGAGCCCGCCG -> TACCCGTATCTCTGAGCCCGCCGT
CTTGCTCCAGAGCATGAATGTATG -> TTGCTCCAGAGCATGAATGTATGT
ATCGGCCTTTATAAATTTACCTTC -> TCGGCCTTTATAAATTTACCTTCA
TCCGACTGGCTGGAGCCGTGGAGG -> CCGACTGGCTGGAGCCGTGGAGGA
CCGTAGAGGCTTCCAGCTTGAGGA -> CGTAGAGGCTTCCAGCTTGAGGAT
AGAGCGCACCATTAGAGAAGCCCT -> GAGCGCACCATTAGAGAAGCCCTA
CTAATTACCAGAGCACAAGCCGAC -> TAATTACCAGAGCACAAGCCGACG
GCGTCGGAAGGTACGTAGAAAATA -> CGTCGGAAGGTACGTAGAAAATAC
TCTCGTCTCACACTGGATCGCATC -> CTCGTCTCACACTGGATCGCATCC
ATGGAACGGGATTCCTTGGCTTTG -> TGGAACGGGATTCCTTGGCTTTGT
TTGTACTTCACTAGTGGGACTGGT -> TGTACTTCACTAGTGGGACTGGTG
CGTGCACGATACCCACTGAGAGCG -> GTGCACGATACCCACTGAGAGCGT
TACTCGTGCAGTCCTTTCAGGACG -> ACTCGTGCAGTCCTTTCAGGACGC
TACTAGCCAAAGTTCGCTTTTTGA -> ACTAGCCAAAGTTCGCTTTTTGAG
ATCCTGTAGGTCGAATGAGGGGCT -> TCCTGTAGGTCGAATGAGGGGCTA
CGCCGACGTAATGCCTGCTGGATG -> GCCGACGTAATGCCTGCTGGATGA
GTTTAGTTAGAGGCCAGCTCCGCG -> TTTAGTTAGAGGCCAGCTCCGCGG
ACTCGTCGTGCGCGCGTACGCCAC -> CTCGTCGTGCGCGCGTACGCCACA
AGTTGGCCACCCAGGATTGGCGCA -> GTTGGCCACCCAGGATTGGCGCAT
GTCATCCTGTAGGTCGAATGAGGG -> TCATCCTGTAGGTCGAATGAGGGG
TATAAAAGTCAGAGGAGCTGAGCG -> ATAAAAGTCAGAGGAGCTGAGCGT
GCTACCCGTATCTCTGAGCCCGCC -> CTACCCGTATCTCTGAGCCCGCCG
GAAGTGTATGTCTAGAGGGGGGAG -> AAGTGTATGTCTAGAGGGGGGAGT
ACCATTAGAGAAGCCCTATCGCCG -> CCATTAGAGAAGCCCTATCGCCGT
CCCGTCGGGCATAAATTCAACTGC -> CCGTCGGGCATAAATTCAACTGCC
ATCGTCCGGCCGCGTGCACGATAC -> TCGTCCGGCCGCGTGCACGATACC
CTTCTGGTGGACGCTCCTCCGTGG -> TTCTGGTGGACGCTCCTCCGTGGA
ATTTACCTTCACCTTAAGCCCGTA -> TTTACCTTCACCTTAAGCCCGTAA
TAATAAGCCCTTGTATAAACGGTG -> AATAAGCCCTTGTATAAACGGTGA
TCCCAATAATTCCGAAGACAGGTA -> CCCAATAATTCCGAAGACAGGTAG
TGCCTGCTGGATGACGCGTATACG -> GCCTGCTGGATGACGCGTATACGG
GTTCACCGCTTAGGTGTATAAAAG -> TTCACCGCTTAGGTGTATAAAAGT
ATAACCAGATGAGACAACAAAGAA -> TAACCAGATGAGACAACAAAGAAT
ACACTGGATCGCATCCGGCCGAAG -> CACTGGATCGCATCCGGCCGAAGT
GATCGCATCCGGCCGAAGTGTATG -> ATCGCATCCGGCCGAAGTGTATGT
GACGTAATGCCTGCTGGATGACGC -> ACGTAATGCCTGCTGGATGACGCG
CTGTTGGCGTTGTACTCGTGCAGT -> TGTTGGCGTTGTACTCGTGCAGTC
CATGAATGTATGTTGAACCGGACA -> ATGAATGTATGTTGAACCGGACAT
TTTGTAATTTTTATGCAACTATAG -> TTGTAATTTTTATGCAACTATAGT
CCTTCACCTTAAGCCCGTAATTAT -> CTTCACCTTAAGCCCGTAATTATT
GCACTCCCCTCGTACTTTGGTAGA -> CACTCCCCTCGTACTTTGGTAGAT
ACTGAGGTTGGCCCTTCATTTAGC -> CTGAGGTTGGCCCTTCATTTAGCA
TCGAAAGACTTTGGCGTTCCGACT -> CGAAAGACTTTGGCGTTCCGACTG
GGCCCAAAAGGTAATGGTTCAGAT -> GCCCAAAAGGTAATGGTTCAGATG
GAGCTGAGCGTCGACTCTACCACA -> AGCTGAGCGTCGACTCTACCACAC
GGCTTCACCGCTGCCCCCCCCATG -> GCTTCACCGCTGCCCCCCCCATGC
CATAGTTGTACTTCACTAGTGGGA -> ATAGTTGTACTTCACTAGTGGGAC
GAAAGAGCGCACCATTAGAGAAGC -> AAAGAGCGCACCATTAGAGAAGCC
GTTGTACTTCACTAGTGGGACTGG -> TTGTACTTCACTAGTGGGACTGGT
AATTCCGAAGACAGGTAGTTGGAC -> ATTCCGAAGACAGGTAGTTGGACT
TTTTGTACAGTTCGTTTAGTTAGA -> TTTGTACAGTTCGTTTAGTTAGAG
CTTAAGCCCGTAATTATTCATCTA -> TTAAGCCCGTAATTATTCATCTAC
AGAGGCTTCCAGCTTGAGGATTTA -> GAGGCTTCCAGCTTGAGGATTTAG
GTAATTTTTATGCAACTATAGTGC -> TAATTTTTATGCAACTATAGTGCG
ATGTTGAACCGGACATCTACAACA -> TGTTGAACCGGACATCTACAACAT
AATTATTCATCTACTCCACCGCAG -> ATTATTCATCTACTCCACCGCAGT
ATTTCGCTGTTGTCCGATAACACA -> TTTCGCTGTTGTCCGATAACACAA
AGAGGAGCTGAGCGTCGACTCTAC -> GAGGAGCTGAGCGTCGACTCTACC
TCCAGAGCATGAATGTATGTTGAA -> CCAGAGCATGAATGTATGTTGAAC
GAATGAACGCAGTGCCCTACCCCC -> AATGAACGCAGTGCCCTACCCCCA
ATAAAAGTCAGAGGAGCTGAGCGT -> TAAAAGTCAGAGGAGCTGAGCGTC
TTGTATAAACGGTGACCCCCGGAG -> TGTATAAACGGTGACCCCCGGAGG
ATACGGCACTTGGGAAGTCCCAAC -> TACGGCACTTGGGAAGTCCCAACT
GCCTGCTGGATGACGCGTATACGG -> CCTGCTGGATGACGCGTATACGGG
AGTGTTGATTGATGCGGCTACATG -> GTGTTGATTGATGCGGCTACATGG
TCAGAGGAGCTGAGCGTCGACTCT -> CAGAGGAGCTGAGCGTCGACTCTA
TGGTCTTCTGGTGGACGCTCCTCC -> GGTCTTCTGGTGGACGCTCCTCCG
GCCACCCAGGATTGGCGCATACAC -> CCACCCAGGATTGGCGCATACACG
GGAGTCTACCCACTAGTGTTTAAT -> GAGTCTACCCACTAGTGTTTAATA
GATGACGCGTATACGGGTATCTAA -> ATGACGCGTATACGGGTATCTAAT
CCCCCCCCATGCTCGGCGTACAGA -> CCCCCCCATGCTCGGCGTACAGAG
AAAGACTTTGGCGTTCCGACTGGC -> AAGACTTTGGCGTTCCGACTGGCT
GGACGCTCCTCCGTGGAGGACCAC -> GACGCTCCTCCGTGGAGGACCACT
CAATTTGGAGTCATGAGCCGGACC -> AATTTGGAGTCATGAGCCGGACCT
TGCATAGGTCGTCTTGACCTGGGC -> GCATAGGTCGTCTTGACCTGGGCA
CCAAAAGGTAATGGTTCAGATGCA -> CAAAAGGTAATGGTTCAGATGCAC
CCCTACGCAGGATATTTTCTACAA -> CCTACGCAGGATATTTTCTACAAT
ATCATATGTGTCGTGAAGAGGAGA -> TCATATGTGTCGTGAAGAGGAGAT
GCACAAGCCGACGATCGGCCTTTA -> CACAAGCCGACGATCGGCCTTTAT
TAGTTGTACTTCACTAGTGGGACT -> AGTTGTACTTCACTAGTGGGACTG
CACCCAGGATTGGCGCATACACGA -> ACCCAGGATTGGCGCATACACGAT
ACAGTTCGTTTAGTTAGAGGCCAG -> CAGTTCGTTTAGTTAGAGGCCAGC
GGATCGCATCCGGCCGAAGTGTAT -> GATCGCATCCGGCCGAAGTGTATG
ATCCCAATAATTCCGAAGACAGGT -> TCCCAATAATTCCGAAGACAGGTA
TCACCTTAAGCCCGTAATTATTCA -> CACCTTAAGCCCGTAATTATTCAT
CTACCGATTCTGTTAAGGCGTCAT -> TACCGATTCTGTTAAGGCGTCATC
GCGGCAGCCCAGAATCCCGTATCC -> CGGCAGCCCAGAATCCCGTATCCC
TTTTGTAATTTTTATGCAACTATA -> TTTGTAATTTTTATGCAACTATAG
CACTGGATCGCATCCGGCCGAAGT -> ACTGGATCGCATCCGGCCGAAGTG
CACCAGCCTAGTGTTCGCCTGCCC -> ACCAGCCTAGTGTTCGCCTGCCCG
GACAATTTGTGGTCAACAGGCGAA -> ACAATTTGTGGTCAACAGGCGAAC
TAGGTCGAATGAGGGGCTAGTCAG -> AGGTCGAATGAGGGGCTAGTCAGG
GCATGAATGTATGTTGAACCGGAC -> CATGAATGTATGTTGAACCGGACA
GGAGCGATGACCTACAGCGCAGTA -> GAGCGATGACCTACAGCGCAGTAA
GTGCAGTCCTTTCAGGACGCGTCG -> TGCAGTCCTTTCAGGACGCGTCGG
GCGACAGCAATGATGAGCTAAATA -> CGACAGCAATGATGAGCTAAATAG
ACTATAGTGCGCCGACGTAATGCC -> CTATAGTGCGCCGACGTAATGCCT
GCTTCAAGTGCGATGCGTGGATCA -> CTTCAAGTGCGATGCGTGGATCAT
GAATCGTCCGGCCGCGTGCACGAT -> AATCGTCCGGCCGCGTGCACGATA
TTTTTGCCGCATGCGACAGCAATG -> TTTTGCCGCATGCGACAGCAATGA
ACGATATTTCGCACTACCACGGGC -> CGATATTTCGCACTACCACGGGCA
TGAGCGTCGACTCTACCACACTGA -> GAGCGTCGACTCTACCACACTGAC
GACGCTCCTCCGTGGAGGACCACT -> ACGCTCCTCCGTGGAGGACCACTC
GTACTTTGGTAGATACAGACGGGA -> TACTTTGGTAGATACAGACGGGAA
TAGATACAGACGGGAAGCCATAGT -> AGATACAGACGGGAAGCCATAGTC
ACAACATCTCGCCGTTGGGAGCGA -> CAACATCTCGCCGTTGGGAGCGAT
TTACTTAAGCTTCAAGTGCGATGC -> TACTTAAGCTTCAAGTGCGATGCG
CCTATCGCCGTTTTGTAATTTTTA -> CTATCGCCGTTTTGTAATTTTTAT
CGTCGGAAGACAGACTTGCTCCAG -> GTCGGAAGACAGACTTGCTCCAGA
TGGAGGAAAATACGGCACTTGGGA -> GGAGGAAAATACGGCACTTGGGAA
CCGTAATTATTCATCTACTCCACC -> CGTAATTATTCATCTACTCCACCG
TTACCTTCACCTTAAGCCCGTAAT -> TACCTTCACCTTAAGCCCGTAATT
ACTGGCTGGAGCCGTGGAGGAAAA -> CTGGCTGGAGCCGTGGAGGAAAAT
CTAGTCAGGGACATAGTTGTACTT -> TAGTCAGGGACATAGTTGTACTTC
AATGCCTGCTGGATGACGCGTATA -> ATGCCTGCTGGATGACGCGTATAC
CTGAGGTTGGCCCTTCATTTAGCA -> TGAGGTTGGCCCTTCATTTAGCAA
ACCGCCGGCTCGATGCTCGTCCTC -> CCGCCGGCTCGATGCTCGTCCTCA
TGCTCCAGAGCATGAATGTATGTT -> GCTCCAGAGCATGAATGTATGTTG
TTAGTTAGAGGCCAGCTCCGCGGC -> TAGTTAGAGGCCAGCTCCGCGGCC
ATGGGTCCCGTCGGGCATAAATTC -> TGGGTCCCGTCGGGCATAAATTCA
CGATACCCACTGAGAGCGTATGAC -> GATACCCACTGAGAGCGTATGACT