ATCGCGCAACG -> TCGCGCAACGG
ATTGCCCCGTG -> TTGCCCCGTGT
TGAACAATCAG -> GAACAATCAGA
CGGCGTCGCGG -> GGCGTCGCGGG
CGCCGTCGAAT -> GCCGTCGAATA
ATGAGTAGGAT -> TGAGTAGGATG
TACTCCTTCCG -> ACTCCTTCCGC
CATCGCCTGGC -> ATCGCCTGGCT
GATGGGCCATC -> ATGGGCCATCT
ATTCACAACAT -> TTCACAACATC
CGGCTATAGGG -> GGCTATAGGGT
CTTGCGGTCAA -> TTGCGGTCAAG
CGGTGTCATGT -> GGTGTCATGTG
GTCTCAGACAT -> TCTCAGACATA
ATGGGCCATCT -> TGGGCCATCTC
AACAGCGTGCC -> ACAGCGTGCCC
TGGGAGCCGTC -> GGGAGCCGTCT
TGAGAAGCTAG -> GAGAAGCTAGT
CACTATAGGAA -> ACTATAGGAAT
GATTCTACGGA -> ATTCTACGGAA
GATTTCATGCC -> ATTTCATGCCG
GTCATGTGATC -> TCATGTGATCA
CCAGGTTTGTC -> CAGGTTTGTCT
GCCCTTCTCTG -> CCCTTCTCTGT
ACTGAGAAGCT -> CTGAGAAGCTA
GAGGGCGGAAC -> AGGGCGGAACT
TATGGCCTAGT -> ATGGCCTAGTA
AACTCTTTCCT -> ACTCTTTCCTG
CTTCTATGGCA -> TTCTATGGCAT
GCGTGCCCATC -> CGTGCCCATCG
CGTTCTTTTAC -> GTTCTTTTACA
TGGTGTATGGC -> GGTGTATGGCC
TTTTTTTAGGT -> TTTTTTAGGTC
CGTTTAGATGA -> GTTTAGATGAG
TCTAGGTAGAG -> CTAGGTAGAGG
AGTTCACGTCG -> GTTCACGTCGT
CACCGCCGTCG -> ACCGCCGTCGA
CTGATTCTACG -> TGATTCTACGG
CCATGGGGATT -> CATGGGGATTT
TTCGGACGACG -> TCGGACGACGG
CACAACATCAG -> ACAACATCAGG
AGTTGCCCGTT -> GTTGCCCGTTT
GTACTACGGCT -> TACTACGGCTA
GCTACCAGTCA -> CTACCAGTCAA
AGAGTTTCCAG -> GAGTTTCCAGT
GTGGTGATCAA -> TGGTGATCAAT
AGAGCCGTATT -> GAGCCGTATTA
TTACTTGCGGG -> TACTTGCGGGG
TGCCGTCGTTT -> GCCGTCGTTTA
TCTGACAGCGT -> CTGACAGCGTC
AGGAACGCTGA -> GGAACGCTGAG
GGCTGATTCTA -> GCTGATTCTAC
GTGAGACCTGG -> TGAGACCTGGC
ACGACGGCGTC -> CGACGGCGTCG
CACAGTTTTTT -> ACAGTTTTTTT
GGAAGACTGAG -> GAAGACTGAGA
GTTAGAGCTGA -> TTAGAGCTGAC
TCCAGGTTTGT -> CCAGGTTTGTC
GTGCTCATTGC -> TGCTCATTGCC
TATTCACAACA -> ATTCACAACAT
GGCTAAGCTGA -> GCTAAGCTGAT
TTTACTCTCGC -> TTACTCTCGCC
ATGGTGTATGG -> TGGTGTATGGC
CCCGGACTCCA -> CCGGACTCCAT
ATGTGTAAAAC -> TGTGTAAAACG
GACCTAAAAGA -> ACCTAAAAGAT
TTTCCGTCCTA -> TTCCGTCCTAG
GTCTATGGTGT -> TCTATGGTGTA
CAGTCAATTGT -> AGTCAATTGTC
GATGATCGAAG -> ATGATCGAAGT
AGGATACGATG -> GGATACGATGA
ATTATCGGTTG -> TTATCGGTTGT
TCGTTTACCGA -> CGTTTACCGAA
TTTCTATCGGC -> TTCTATCGGCT
TTTATCTGCAG -> TTATCTGCAGC
CTTTCTACTAC -> TTTCTACTACC
CGAGTTGAGGG -> GAGTTGAGGGA
AGGCGCCATCT -> GGCGCCATCTA
TCCCCCTCGGT -> CCCCCTCGGTA
TGTTGTGGGCG -> GTTGTGGGCGG
TATCTGCAGCT -> ATCTGCAGCTT
CCTCGTATGAC -> CTCGTATGACG
CATGAGCCTGT -> ATGAGCCTGTA
ATACGATGATC -> TACGATGATCG
CTACTTGTACT -> TACTTGTACTT
CGTAGATTTGG -> GTAGATTTGGA
TGTACTCCAGG -> GTACTCCAGGT
CTATGGACGTT -> TATGGACGTTT
CTACCAGTCAA -> TACCAGTCAAT
TAAACACGCAA -> AAACACGCAAG
ACCGAGTTGAG -> CCGAGTTGAGG
TGTTACACAAG -> GTTACACAAGT
TACCAGTCAAT -> ACCAGTCAATT
ATGTAAATCAG -> TGTAAATCAGA
CCGTGGCTGCT -> CGTGGCTGCTC
AGCAAAGATGC -> GCAAAGATGCG
CTGACTTGTGC -> TGACTTGTGCG
ACCCGTTTTAC -> CCCGTTTTACC
TGGCCGTCTAT -> GGCCGTCTATC
TGTTTTCACAT -> GTTTTCACATA
CCCGTTTTACC -> CCGTTTTACCG
TCAATCTATGG -> CAATCTATGGA
GTGCAGAGTTG -> TGCAGAGTTGC
ACGAATACATT -> CGAATACATTA
CTGACCAACTG -> TGACCAACTGT
ACTAAACCGAA -> CTAAACCGAAA
CAGACCGTGGC -> AGACCGTGGCT
CTAGGTAGAGG -> TAGGTAGAGGG
TTTGGCGGTAC -> TTGGCGGTACC
TTTCCAGTCTT -> TTCCAGTCTTA
TGCAGCTTATT -> GCAGCTTATTG
GTATCATAGCA -> TATCATAGCAT
CGTCGTTTACC -> GTCGTTTACCG
CGGATTCTAAT -> GGATTCTAATG
CATGTGTAAAA -> ATGTGTAAAAC
AGGTTCAAGAA -> GGTTCAAGAAT
GAACGGTGTAT -> AACGGTGTATG
GGCTATAGGGT -> GCTATAGGGTA
GGATTTGGTAC -> GATTTGGTACT
AAAATCTGGGG -> AAATCTGGGGT
CGCTGGAATAA -> GCTGGAATAAA
AGACTTTCTAC -> GACTTTCTACT
CCATGAGCCTG -> CATGAGCCTGT
TTTCCTGATGG -> TTCCTGATGGG
AGAGTTGGTAA -> GAGTTGGTAAA
TAGTAGTGCAG -> AGTAGTGCAGA
GATGAGCCCGA -> ATGAGCCCGAT
TTTAACGGTTC -> TTAACGGTTCT
CTATTCTTAAG -> TATTCTTAAGA
TCATAGTGTGC -> CATAGTGTGCT
GTTGGATTTGG -> TTGGATTTGGT
TGACGTGTTCC -> GACGTGTTCCT
GCGCCATCTAC -> CGCCATCTACG
ATCGGGATCTG -> TCGGGATCTGC
TAAGACCCAAT -> AAGACCCAATC
CTCGTATGACG -> TCGTATGACGT
AGTCTTACTTG -> GTCTTACTTGC
GATCGCGCTTT -> ATCGCGCTTTG
GGTAGCAAACT -> GTAGCAAACTT
GGCATTCGTTC -> GCATTCGTTCT
TGGCTAAGGTT -> GGCTAAGGTTC
TTGTATTTAGA -> TGTATTTAGAG
CTTATTCGCGT -> TTATTCGCGTT
AGCCAAAAATC -> GCCAAAAATCT
TGGCATTAATA -> GGCATTAATAC
CCCCTCGGTAC -> CCCTCGGTACG
TAGTGAGCTGT -> AGTGAGCTGTA
GCCCTTTCCCT -> CCCTTTCCCTC
GTGTGTGGGCT -> TGTGTGGGCTC
GCGGGCGCCAG -> CGGGCGCCAGG
TCTTACCATTT -> CTTACCATTTC
CATAGGGCGGG -> ATAGGGCGGGT
AGAATCTAGAC -> GAATCTAGACA
TGTCATACAGG -> GTCATACAGGA
TAGCCAAAAAT -> AGCCAAAAATC
CAGTCCGCTGT -> AGTCCGCTGTT
GTCGTTTACCG -> TCGTTTACCGA
ACTCTTTCCTG -> CTCTTTCCTGA
GCATCATAGTG -> CATCATAGTGT
CCCGACTGTCC -> CCGACTGTCCT
TCGGCTCGCTG -> CGGCTCGCTGC
TTATCAGTCAG -> TATCAGTCAGA
CGTCGAATATG -> GTCGAATATGA
ATCGGTGGAAG -> TCGGTGGAAGA
ACGCTAAGGTA -> CGCTAAGGTAG
TCCTACTTGTA -> CCTACTTGTAC
ATCGCTACTTA -> TCGCTACTTAT
ACCGCCTAAAG -> CCGCCTAAAGG
TATCATAGCAT -> ATCATAGCATC
ATTTCGTAGTG -> TTTCGTAGTGA
GCCTGTAATGC -> CCTGTAATGCA
CTAAAGTTCGG -> TAAAGTTCGGA
TGAGTGCATAC -> GAGTGCATACC
TTCTTAAGACC -> TCTTAAGACCC
AGTAGTGCAGA -> GTAGTGCAGAG
TAGATACATAG -> AGATACATAGG
ATACAGAAGAC -> TACAGAAGACG
ACTTGTTGGAT -> CTTGTTGGATT
ACTCTGGCATT -> CTCTGGCATTC
CCAGTCAATTG -> CAGTCAATTGT
ACGTTACCCTC -> CGTTACCCTCG
ACTTGCGGTCA -> CTTGCGGTCAA
GAATATGAACA -> AATATGAACAA
TCGTTTAGATG -> CGTTTAGATGA
TCATTGCCCCG -> CATTGCCCCGT
CATTCTAGGTA -> ATTCTAGGTAG
GCTGAGATCCT -> CTGAGATCCTG
CCAGGAAGACG -> CAGGAAGACGA
GCCATGTGTAA -> CCATGTGTAAA
TGCTAAAGTTC -> GCTAAAGTTCG
AACTTGCGGTC -> ACTTGCGGTCA
TTTACCGGTTT -> TTACCGGTTTC
GACGAACTTGT -> ACGAACTTGTT
ACGCGGGCTGC -> CGCGGGCTGCT
AATGCCGTATT -> ATGCCGTATTC
AGTGAGACCTG -> GTGAGACCTGG
GAATATCTTCA -> AATATCTTCAT
AGCGTGCCCAT -> GCGTGCCCATC
AAATCTGGGGT -> AATCTGGGGTG
GGACTCCATGT -> GACTCCATGTT
TTCACGTCGTT -> TCACGTCGTTT
CGTCGGATTCT -> GTCGGATTCTA
TTATTCGCGTT -> TATTCGCGTTG
TTTACATTTAA -> TTACATTTAAC
TTGTCAAGACC -> TGTCAAGACCT
ACTTGCGGGGT -> CTTGCGGGGTA
ATCAGGGCTAA -> TCAGGGCTAAC
GGGGTGGAATG -> GGGTGGAATGC
CTTTGGCGGTA -> TTTGGCGGTAC
CACTAAACCGA -> ACTAAACCGAA
CCGTCTATCTA -> CGTCTATCTAA
GGACAGTTGAA -> GACAGTTGAAG
TGAAGACTAGA -> GAAGACTAGAG
CAACGCCATGT -> AACGCCATGTG
TGTGTAAAACG -> GTGTAAAACGA
TAGTGTGCTCA -> AGTGTGCTCAT
TGGAGTATCTC -> GGAGTATCTCT
CAGGAACGCTG -> AGGAACGCTGA
AAGTTCACGTC -> AGTTCACGTCG
TCGGATTCTAA -> CGGATTCTAAT
TAGCAAACTTG -> AGCAAACTTGT
GTATCTCTATG -> TATCTCTATGA
TGATCAACGCT -> GATCAACGCTC
CTCCCCCTCGG -> TCCCCCTCGGT
ATCAACGCTCC -> TCAACGCTCCT
ATCGGTTGTCC -> TCGGTTGTCCT
TCTATCGGCTC -> CTATCGGCTCG
GGATGTTCACC -> GATGTTCACCA
GAATTTCTGAC -> AATTTCTGACA
TTCTACTACCC -> TCTACTACCCC
CGCGGGCTGCT -> GCGGGCTGCTT
GGAATAAACCA -> GAATAAACCAC
TTAGAGCTGAC -> TAGAGCTGACT
TGAGTAAAGCC -> GAGTAAAGCCG
AACCTGGAGTA -> ACCTGGAGTAT
CATTTAACCGG -> ATTTAACCGGG
TTTTACCGGTT -> TTTACCGGTTT
CCTAGATACAT -> CTAGATACATA
CAAGACCTAAA -> AAGACCTAAAA
TGGAGTTAGAG -> GGAGTTAGAGC
CAATCAGAGTT -> AATCAGAGTTT
TATGACGTGTT -> ATGACGTGTTC
GGGTCTACCAT -> GGTCTACCATA
TGAGGGAGGGC -> GAGGGAGGGCG
TATTTTGTAGT -> ATTTTGTAGTC
GAGGTGTCATA -> AGGTGTCATAC
AACTTGTTGTG -> ACTTGTTGTGG
ACCGAACAGCG -> CCGAACAGCGT
CTACGTTACCC -> TACGTTACCCT
GGTCAAGGCGT -> GTCAAGGCGTG
TATGGTGTATG -> ATGGTGTATGG
GAGACCTGGCC -> AGACCTGGCCG
AACGATCGCGC -> ACGATCGCGCT,ACGATCGCGCA
TACGTGAGTGC -> ACGTGAGTGCA
CAACGGCCCTA -> AACGGCCCTAA
AACCGGGCCGA -> ACCGGGCCGAT
CCTGTAATGCA -> CTGTAATGCAC
GACATACTCCT -> ACATACTCCTT
GATCGCGCAAC -> ATCGCGCAACG
ACCCCAGCTGG -> CCCCAGCTGGC
ATCAATCTATG -> TCAATCTATGG
GGCCGTCTATC -> GCCGTCTATCT
AAGGTAGTGAA -> AGGTAGTGAAC
TTAGAGGTGTC -> TAGAGGTGTCA
GGACATCCATG -> GACATCCATGG
TGATCGAAGTA -> GATCGAAGTAC
CCGTCGAATAT -> CGTCGAATATG
CAGGCTGACCA -> AGGCTGACCAA
AACAATCAGAG -> ACAATCAGAGT
GACTGAGAAGC -> ACTGAGAAGCT
TCTTACAATCA -> CTTACAATCAG
ACCGCGCAGAC -> CCGCGCAGACC
GCCTAGTAGAA -> CCTAGTAGAAT
CTGTACAGTAG -> TGTACAGTAGA
GCCCTAAGTAT -> CCCTAAGTATG
GCTCTCTCTGT -> CTCTCTCTGTT
GGCTAACTGCC -> GCTAACTGCCA
ATTTACTCTCG -> TTTACTCTCGC
TAGCATCCAAG -> AGCATCCAAGT
ATCCAAGTCTC -> TCCAAGTCTCA
CGCGGCAATGA -> GCGGCAATGAG
ACGCTGAGATC -> CGCTGAGATCC
CACTACTCTGT -> ACTACTCTGTA
TGGGCTCGGCG -> GGGCTCGGCGC
AGGGAATCACC -> GGGAATCACCG
GGATCTCTAAC -> GATCTCTAACC
GTCAAGGCGTG -> TCAAGGCGTGG
GGAAGACGAAC -> GAAGACGAACT
TGTCTTACCAT -> GTCTTACCATT
GGCGGAATGGA -> GCGGAATGGAC
TAACCTGGAGT -> AACCTGGAGTA
TTCTATGGCAT -> TCTATGGCATC
CGGTCAAGGCG -> GGTCAAGGCGT
CTCCATGTTTA -> TCCATGTTTAT
AACGCTGAGAT -> ACGCTGAGATC
GGCGGTGTCAT -> GCGGTGTCATG
AGCTGATCAAC -> GCTGATCAACG
GCGTTGTGGAT -> CGTTGTGGATC
GGACTGGAGTT -> GACTGGAGTTA
ACTACTCTGTA -> CTACTCTGTAT
CCAGGCTGACC -> CAGGCTGACCA
GAAACGCCCTT -> AAACGCCCTTC
AGCATCGCTAC -> GCATCGCTACT
CTGGCATTCGT -> TGGCATTCGTT
GGTTCTTGCCA -> GTTCTTGCCAC
GCTTGACGGAC -> CTTGACGGACT
GGAACGCTGAG -> GAACGCTGAGA
GACTGTCCTTC -> ACTGTCCTTCT
GGAGAGACTAC -> GAGAGACTACG
ATCAGGAACGC -> TCAGGAACGCT
CTCGCGGCAAT -> TCGCGGCAATG
AGTTTGCTACC -> GTTTGCTACCA
TCTATCTAACA -> CTATCTAACAC
AGGGCGGGTAG -> GGGCGGGTAGC
AGTTGGTAAAC -> GTTGGTAAACA
CAACGTATATC -> AACGTATATCA
CGTAGTGAGCT -> GTAGTGAGCTG
AAGCTAGTAGT -> AGCTAGTAGTG
TTTTCTGGGGT -> TTTCTGGGGTC
ACATAACCGCC -> CATAACCGCCT
TCTACCATAAC -> CTACCATAACT
CGTGAGTGCAT -> GTGAGTGCATA
GTTCACGTCGT -> TTCACGTCGTT
TTTGTCTTACC -> TTGTCTTACCA
CTTGTTGGATT -> TTGTTGGATTT
CGATTCTATAG -> GATTCTATAGG
GCGGGCTTAAT -> CGGGCTTAATC
GGGAGAGACTA -> GGAGAGACTAC
CATAGCATCCA -> ATAGCATCCAA
TATGGCATCAT -> ATGGCATCATA
CTCAGACATAC -> TCAGACATACT
TGGTACTACGG -> GGTACTACGGC
ATCTCGCTCTC -> TCTCGCTCTCT
CTGTTTTCACA -> TGTTTTCACAT
TATAGGGTAGT -> ATAGGGTAGTC
TTTGTAGTCTT -> TTGTAGTCTTT
GTTCACCAGAG -> TTCACCAGAGC
AGGGTAGTCGT -> GGGTAGTCGTA
GTTCCTAGATA -> TTCCTAGATAC
TAGCCACAGTT -> AGCCACAGTTT
ACAAGTTCACG -> CAAGTTCACGT
CTCGGCGCAGT -> TCGGCGCAGTG
GATCTGCTAAA -> ATCTGCTAAAG
AGCTGGCCCTT -> GCTGGCCCTTT
ACTTGTGCGTG -> CTTGTGCGTGC
TAACCGGGCCG -> AACCGGGCCGA
AGTCAGAAATC -> GTCAGAAATCT
TAACGATCGCG -> AACGATCGCGC
GTGGGCGGTGT -> TGGGCGGTGTC
ATGATTTCATG -> TGATTTCATGC
GCCTAAAGGGA -> CCTAAAGGGAA
GTATATCAGGA -> TATATCAGGAA
TGAGCTGTATG -> GAGCTGTATGG
GTAGTGAGCTG -> TAGTGAGCTGT
ACGATCGCGCT -> CGATCGCGCTT
TTACCCTCGTA -> TACCCTCGTAT
TCAACGCCATG -> CAACGCCATGT
AGACGCTAAGG -> GACGCTAAGGT
TGGGCCATCTC -> GGGCCATCTCG
TGTAATGCACC -> GTAATGCACCG
GTCGACTTTGG -> TCGACTTTGGC
GGAGTTAGAGC -> GAGTTAGAGCT
ACGGCCCCTGG -> CGGCCCCTGGG
ATTCTACGGAA -> TTCTACGGAAA
CCTCGGTACGA -> CTCGGTACGAA
CATAACTCTTT -> ATAACTCTTTC
GCTACTTATTC -> CTACTTATTCG
TTTCAGAGTTG -> TTCAGAGTTGG
ACTACCCCAGC -> CTACCCCAGCT
CAGAGTTGAAG -> AGAGTTGAAGA
AGACTACGAAC -> GACTACGAACT
TGGCCCTTTCC -> GGCCCTTTCCC
TTGCGGTCAAG -> TGCGGTCAAGG
CACGTCGTTTA -> ACGTCGTTTAG
GACGTTTATCT -> ACGTTTATCTG
ACTTATTCGCG -> CTTATTCGCGT
CAAGGTCAGTC -> AAGGTCAGTCC
GAATCACCGAT -> AATCACCGATT
TTTCCCTCACT -> TTCCCTCACTA
GACATCCATGG -> ACATCCATGGG
GTAAACACGCA -> TAAACACGCAA
GATCAATCTAT -> ATCAATCTATG
TCATCTGCCGC -> CATCTGCCGCA
GCCATCTACGT -> CCATCTACGTT
CCGCTGTTTTC -> CGCTGTTTTCA
CGCTGCGGGCG -> GCTGCGGGCGG
TTAAGACCCAA -> TAAGACCCAAT
GGCATTAATAC -> GCATTAATACA
TTCCTGATGGG -> TCCTGATGGGC
AGTACAAAGGA -> GTACAAAGGAC
AGGACCGAGTT -> GGACCGAGTTG
TATGATTTCAT -> ATGATTTCATG
GGCGTCGCGGG -> GCGTCGCGGGC
TACGAACTGAC -> ACGAACTGACT
TGCCCCGTGTG -> GCCCCGTGTGT
GATAGAAGCAA -> ATAGAAGCAAA
GTTGGCATTAA -> TTGGCATTAAT
TTGCCACAGTT -> TGCCACAGTTT
GTCTATCTAAC -> TCTATCTAACA
GCGGAACTTGC -> CGGAACTTGCG
TATAGGCGCCA -> ATAGGCGCCAT
ACTAGAGGACA -> CTAGAGGACAT
CACAGTTTGAT -> ACAGTTTGATA
TGACTTGAGTA -> GACTTGAGTAA
GGAGGCTTTCC -> GAGGCTTTCCG
GGGTGGAATGC -> GGTGGAATGCC
ATCTAGACACT -> TCTAGACACTC
GCGGGTAGCCA -> CGGGTAGCCAC
ATAATGGCAAT -> TAATGGCAATC
AATCTAGACAC -> ATCTAGACACT
TCCGCTGTTTT -> CCGCTGTTTTC
ATTATCAGTCA -> TTATCAGTCAG
GATGCGGGCTG -> ATGCGGGCTGA
ATCATTCTAGG -> TCATTCTAGGT
CATCAGGGCTA -> ATCAGGGCTAA
TATGGACGTTT -> ATGGACGTTTA
GACACTCTGGC -> ACACTCTGGCA
ACATAGGGCGG -> CATAGGGCGGG
ATTTAACCGGG -> TTTAACCGGGC
CCGACTGTCCT -> CGACTGTCCTT
AGAAATCTTAC -> GAAATCTTACA
TCTACTACCCC -> CTACTACCCCA
GACCAACTGTA -> ACCAACTGTAA
CATTTTTCTGG -> ATTTTTCTGGG
CGGGTAGCCAC -> GGGTAGCCACC
TTCTAATGAAG -> TCTAATGAAGA
TGTACAGTAGA -> GTACAGTAGAC
CCGTATTCACA -> CGTATTCACAA
ACAATCAGCAT -> CAATCAGCATC
CTAAACCGAAA -> TAAACCGAAAC
GGGCCATCTCG -> GGCCATCTCGC
ATCTCTATGAT -> TCTCTATGATT
AACATCAGGGC -> ACATCAGGGCT
ATGGGAGAGAC -> TGGGAGAGACT
CTACTCTGTAT -> TACTCTGTATC
TCAGAGTTTCC -> CAGAGTTTCCA
ACACGCAAGGT -> CACGCAAGGTC
GGGCCGATTAT -> GGCCGATTATC
TAGAAGCAAAG -> AGAAGCAAAGA
CAGCTTATTGT -> AGCTTATTGTT
GAACTTGCGGT -> AACTTGCGGTC
GTTTACCGAAC -> TTTACCGAACA
CAGACGGCCCC -> AGACGGCCCCT
GATTTGGAAGC -> ATTTGGAAGCT
CCTAGGCTAAG -> CTAGGCTAAGC
TTGTCGACTTT -> TGTCGACTTTG
AGTAGGATGTT -> GTAGGATGTTC
AACTGCCAACG -> ACTGCCAACGT
CCATGTGTAAA -> CATGTGTAAAA
TTGGCGGTACC -> TGGCGGTACCC
GTGTAAAACGA -> TGTAAAACGAT
CTTCATAGTGA -> TTCATAGTGAG
GCCAGGCTGAT -> CCAGGCTGATT
CGGAGGCTTTC -> GGAGGCTTTCC
TCTGCCGCATT -> CTGCCGCATTT
GGGACGTCGCG -> GGACGTCGCGC
TTACACAAGTT -> TACACAAGTTC
GTTACCCTCGT -> TTACCCTCGTA
GCTGCGGGCGG -> CTGCGGGCGGA
ATTGTTCCTTT -> TTGTTCCTTTA
CTTTCCTGATG -> TTTCCTGATGG
AAGATTTCGTA -> AGATTTCGTAG
GCCCGTTTGGT -> CCCGTTTGGTG
GGCTGCTCCAG -> GCTGCTCCAGG
CCCTTCTCTGT -> CCTTCTCTGTT
CATCTCGCTCT -> ATCTCGCTCTC
ATCACCGATTC -> TCACCGATTCT
TGTCTCTGTAC -> GTCTCTGTACA
AGGTAGAGGGT -> GGTAGAGGGTT
GTTTTACCGGT -> TTTTACCGGTT
AAAGATAGAAG -> AAGATAGAAGC
GGAATGCCGTA -> GAATGCCGTAT
TCTCGCCCGAC -> CTCGCCCGACT
AGACGCGGGCT -> GACGCGGGCTG
GGCCATCTCGC -> GCCATCTCGCT
AATTTCTGACA -> ATTTCTGACAG
GTCGGATTCTA -> TCGGATTCTAA
AACGCTGGAAT -> ACGCTGGAATA
ACGGCGTCGCG -> CGGCGTCGCGG
AACTGACTTGT -> ACTGACTTGTG
CGTGGCTAAGG -> GTGGCTAAGGT
GGGTAGCCACC -> GGTAGCCACCA
AGCTTGTCAAG -> GCTTGTCAAGA
TGTAGTCTTTA -> GTAGTCTTTAC
AAACTTGTTGT -> AACTTGTTGTG
TGGAAGACTGA -> GGAAGACTGAG
AATGGCAATCC -> ATGGCAATCCT
AGATGCGGGCT -> GATGCGGGCTG
CATAGTGTGCT -> ATAGTGTGCTC
AATCAGACGGC -> ATCAGACGGCC
CGTTTAGCCAA -> GTTTAGCCAAA
ACGCCCTTCTC -> CGCCCTTCTCT
GGGAGGGCGGA -> GGAGGGCGGAA
TAAACCGAAAC -> AAACCGAAACG
TGCTCATTGCC -> GCTCATTGCCC
GATACATAGGG -> ATACATAGGGC
CATCCAAGTCT -> ATCCAAGTCTC
TCAACGCTCCT -> CAACGCTCCTA
TCACTACTCTG -> CACTACTCTGT
TCACATAACCG -> CACATAACCGC
TTACCGAACAG -> TACCGAACAGC
CTAGAGGACAT -> TAGAGGACATC
AACACGCAAGG -> ACACGCAAGGT
AACGCCCTTCT -> ACGCCCTTCTC
GCGGTCAAGGC -> CGGTCAAGGCG
TTCTATTATCA -> TCTATTATCAG
GGTACGAATAC -> GTACGAATACA
AATGAGTAGGA -> ATGAGTAGGAT
TGGGGTCTACC -> GGGGTCTACCA
CTTTGTCTCTG -> TTTGTCTCTGT
GTCGTTTAGAT -> TCGTTTAGATG
GGGATTTACTC -> GGATTTACTCT
GGAATCACCGA -> GAATCACCGAT
CGCCCGACTGT -> GCCCGACTGTC
GGTAGCCACCA -> GTAGCCACCAG
GTCATCTGCCG -> TCATCTGCCGC
CGCCCCAGCTT -> GCCCCAGCTTG
CGTCTTATTTT -> GTCTTATTTTG
GTAGCCACCAG -> TAGCCACCAGA
ACCATGAGCCT -> CCATGAGCCTG
GCGTGCGGAAG -> CGTGCGGAAGT
GTCCTCGCGGC -> TCCTCGCGGCA
GTTCAAGAATC -> TTCAAGAATCT
CGTCTTTCATA -> GTCTTTCATAC
CTACGAACTGA -> TACGAACTGAC
CTCTGTATCAT -> TCTGTATCATA
ATTAATACAGA -> TTAATACAGAG
AGGATCAATCT -> GGATCAATCTA
TGTCCTTCTAT -> GTCCTTCTATG
CTATTCTATTA -> TATTCTATTAT
CCATAACTCTT -> CATAACTCTTT
GATCAACGCTC -> ATCAACGCTCC
TGCCCATCGCC -> GCCCATCGCCT
CCCTGGGACGT -> CCTGGGACGTC
GACGTCGCGCT -> ACGTCGCGCTA
ACAGTTGAAGA -> CAGTTGAAGAA
AGTGAACGGTG -> GTGAACGGTGT
AGTTAGAGCTG -> GTTAGAGCTGA
CGAAGTACAAA -> GAAGTACAAAG
AGGGAGGGCGG -> GGGAGGGCGGA
TGGGATTTACT -> GGGATTTACTC
GGCCCCTGGGA -> GCCCCTGGGAC
TGAGTCATCTG -> GAGTCATCTGC
CGCGCAGACCG -> GCGCAGACCGT
CCCCAGCTTGT -> CCCAGCTTGTC
ACTCCCCCTCG -> CTCCCCCTCGG
CTTGTGCGTGC -> TTGTGCGTGCG
TGCCCGTTTGG -> GCCCGTTTGGT
TGGATCGGTGG -> GGATCGGTGGA
TTACAATCAGC -> TACAATCAGCA
AGGTTTGTCTT -> GGTTTGTCTTA
TAGGGTAGTCG -> AGGGTAGTCGT
GCTAACTGCCA -> CTAACTGCCAA
GTTTGATAATG -> TTTGATAATGG
GAAGATTTCGT -> AAGATTTCGTA
TTGGTAAACAC -> TGGTAAACACG
GACGTGTTCCT -> ACGTGTTCCTA
GAGATCCTGCG -> AGATCCTGCGT
CGGTTCTTGCC -> GGTTCTTGCCA
TCTCTGTACAG -> CTCTGTACAGT
TAAAACGATCG -> AAAACGATCGC
TACTCCAGGTT -> ACTCCAGGTTT
CAACACTAAAC -> AACACTAAACC
TGGGAGAGACT -> GGGAGAGACTA
GGGAATCACCG -> GGAATCACCGA
TGTTCACCAGA -> GTTCACCAGAG
GAAGACTGAGA -> AAGACTGAGAA
TCTCGCTCTCT -> CTCGCTCTCTC
ACAACATCAGG -> CAACATCAGGG
ACTCTCGCCCG -> CTCTCGCCCGA
TACAGAGTTGA -> ACAGAGTTGAA
TTTTAGGTCTA -> TTTAGGTCTAT
AACACTAAACC -> ACACTAAACCG
CGTTGTGGATC -> GTTGTGGATCG
AATCCTGAGTC -> ATCCTGAGTCA
AAGCCGGAGGC -> AGCCGGAGGCT
AGTGTACTCCA -> GTGTACTCCAG
GAACAATCAGA -> AACAATCAGAG
TAATACAGAGT -> AATACAGAGTT
AACAAGACTTT -> ACAAGACTTTC
ATGCAACACTA -> TGCAACACTAA
CAGTTGAAGAA -> AGTTGAAGAAC
GCGTCGGATTC -> CGTCGGATTCT
AGACCCAATCG -> GACCCAATCGT
GGCGCAGTGTA -> GCGCAGTGTAC
TTGTTGGATTT -> TGTTGGATTTG
GCCCCTGGGAC -> CCCCTGGGACG
GGCAATCCTAT -> GCAATCCTATT
CTTGTATTTAG -> TTGTATTTAGA
GGTGTATGGCC -> GTGTATGGCCT
TACATTAGCCA -> ACATTAGCCAC
ATCCTGCGTCG -> TCCTGCGTCGG
ATGTGATCAAC -> TGTGATCAACG
TTGTCCTCGCG -> TGTCCTCGCGG
GGATCTGCTAA -> GATCTGCTAAA
GCTGACCAACT -> CTGACCAACTG
ATCGCGCTTTG -> TCGCGCTTTGT
CTTGCGGGGTA -> TTGCGGGGTAG
CTCTGTACAGT -> TCTGTACAGTA
TCATACAGGAT -> CATACAGGATC
TGCCGTATTCA -> GCCGTATTCAC
TAATGAAGACT -> AATGAAGACTA
ACGCAAGGTCA -> CGCAAGGTCAG
CACTCTGGCAT -> ACTCTGGCATT
AAGATAGAAGC -> AGATAGAAGCA
GACCGAGTTGA -> ACCGAGTTGAG
GAAGACTAGAG -> AAGACTAGAGG
CGGTGGAAGAC -> GGTGGAAGACT
AAGACCTAAAA -> AGACCTAAAAG
AATCTGGGGTG -> ATCTGGGGTGG
TTATTGTTCCT -> TATTGTTCCTT
TTTAACGATCG -> TTAACGATCGC
TAACGGTTCTT -> AACGGTTCTTG
ACGAACTGACT -> CGAACTGACTT
CGGTACGAATA -> GGTACGAATAC
GTCGCGGGCGC -> TCGCGGGCGCC
ATAGTGTGCTC -> TAGTGTGCTCA
TTGATAATGGC -> TGATAATGGCA
CGCGGGCTTAA -> GCGGGCTTAAT
GGGCTGCTTGA -> GGCTGCTTGAC
CTGTATGGGAT -> TGTATGGGATT
CCCGTTTGGTG -> CCGTTTGGTGG
CTAACTGCCAA -> TAACTGCCAAC
ACGATCGCGCA -> CGATCGCGCAA
TACGGCTATAG -> ACGGCTATAGG
GCAATCCTATT -> CAATCCTATTC
AGATTTCGTAG -> GATTTCGTAGT
TACGTTACCCT -> ACGTTACCCTC
TAGTAGAATAT -> AGTAGAATATC
AAGTACAAAGG -> AGTACAAAGGA
TCTCTCTGTTA -> CTCTCTGTTAC
ATCAATCATTC -> TCAATCATTCT
TTAGCCACAGT -> TAGCCACAGTT
TCGACTTTGGC -> CGACTTTGGCG
TAAATCAGACG -> AAATCAGACGG
CCAAAAATCTG -> CAAAAATCTGG
TCTCTGTTACA -> CTCTGTTACAC
GATTTAACGAT -> ATTTAACGATC
TCGCCTGGCTA -> CGCCTGGCTAT
TCGCGCAACGG -> CGCGCAACGGC
TCTCTATGATT -> CTCTATGATTT
CGGCTCGCTGC -> GGCTCGCTGCG
TCTATGGCATC -> CTATGGCATCA
TTCTGACAGCG -> TCTGACAGCGT
TAAGGGAATCA -> AAGGGAATCAC
GTATTAACAAG -> TATTAACAAGA
CTGTTTTAAGG -> TGTTTTAAGGG
GGAAGTTTGCT -> GAAGTTTGCTA
CATCGCTACTT -> ATCGCTACTTA
AGATGAGCCCG -> GATGAGCCCGA
TACCGAACAGC -> ACCGAACAGCG
AATCGTTTAGC -> ATCGTTTAGCC
TTCTCTGTTTT -> TCTCTGTTTTA
ATAGAAGCAAA -> TAGAAGCAAAG
GTGATCAACGC -> TGATCAACGCC
CGCGTTGTGGA -> GCGTTGTGGAT
GACTGGAGTTA -> ACTGGAGTTAG
GTACTTCCAGG -> TACTTCCAGGA
CGGGCTGAGTC -> GGGCTGAGTCA
GGCGGGTAGCC -> GCGGGTAGCCA
AGTCCGCTGTT -> GTCCGCTGTTT
AGATCCTGCGT -> GATCCTGCGTC
AGGATCTCTAA -> GGATCTCTAAC
AACCACTATAG -> ACCACTATAGG
ATCTGCCGCAT -> TCTGCCGCATT
ACCAGTCAATT -> CCAGTCAATTG
CCAGGCTGATT -> CAGGCTGATTC
GGGGTCTACCA -> GGGTCTACCAT
TTCGTTCTTTT -> TCGTTCTTTTA
ATGTTCACCAG -> TGTTCACCAGA
GGTACTACGGC -> GTACTACGGCT
ATCGTTTAGCC -> TCGTTTAGCCA
GGTAGAGGGTT -> GTAGAGGGTTG
CAATCTATGGA -> AATCTATGGAC
TGGAATGCCGT -> GGAATGCCGTA
ATGTTTATGGG -> TGTTTATGGGA
CAATCGTTTAG -> AATCGTTTAGC
TTGGCATTAAT -> TGGCATTAATA
AACTGTAAGGA -> ACTGTAAGGAT
TTGTCTCTGTA -> TGTCTCTGTAC
AGACACTCTGG -> GACACTCTGGC
CCCAGCTTGTC -> CCAGCTTGTCA
AAAGGGAATTT -> AAGGGAATTTC
GAGTAGGATGT -> AGTAGGATGTT
TTCTTTTACAT -> TCTTTTACATT
GTCCTTCTATG -> TCCTTCTATGG
GCTTAATCCTG -> CTTAATCCTGA
GAAGACGCGGG -> AAGACGCGGGC
TTGGTGGTGAT -> TGGTGGTGATC
ATGCCGTCGTT -> TGCCGTCGTTT
TGCCACAGTTT -> GCCACAGTTTG
ACAGAGTTGAA -> CAGAGTTGAAG
GACTCCATGTT -> ACTCCATGTTT
ATAGGGCGGGT -> TAGGGCGGGTA
CCGCCTAAAGG -> CGCCTAAAGGG
TTATCGGTTGT -> TATCGGTTGTC
TGCTACCAGTC -> GCTACCAGTCA
AGGATGTTCAC -> GGATGTTCACC
ACGCTGGAATA -> CGCTGGAATAA
GATTTACTCTC -> ATTTACTCTCG
CGGCGCAGTGT -> GGCGCAGTGTA
GAAGTTTGCTA -> AAGTTTGCTAC
CTGCCGCATTT -> TGCCGCATTTT
AGACCTGGCCG -> GACCTGGCCGT
CGCTCCTACTT -> GCTCCTACTTG
TATATCAGGAA -> ATATCAGGAAC
TCGCGTTGTGG -> CGCGTTGTGGA
AATGGACAGTT -> ATGGACAGTTG
TTGTACTTCCA -> TGTACTTCCAG
CTGGGACGTCG -> TGGGACGTCGC
TTTGGAAGCTT -> TTGGAAGCTTG
CGCAGTGTACT -> GCAGTGTACTC
ACGATGATCGA -> CGATGATCGAA
ATTCTAATGAA -> TTCTAATGAAG
CAGCTTGTCAA -> AGCTTGTCAAG
ACTGTAAGGAT -> CTGTAAGGATA
GACCTGGCCGT -> ACCTGGCCGTC
TAATGCACCGC -> AATGCACCGCG
CCTATTCTATT -> CTATTCTATTA
ACAATCAGAGT -> CAATCAGAGTT
ATTTCAGAGTT -> TTTCAGAGTTG
ATACATTAGCC -> TACATTAGCCA
CGCAAGGTCAG -> GCAAGGTCAGT
CATTCGTTCTT -> ATTCGTTCTTT
TTTCACATAAC -> TTCACATAACC
CCGAAACGCCC -> CGAAACGCCCT
GATGTTCACCA -> ATGTTCACCAG
AAGATGCGGGC -> AGATGCGGGCT
TTGTGGGCGGT -> TGTGGGCGGTG
GCATCCAAGTC -> CATCCAAGTCT
TACTTGCGGGG -> ACTTGCGGGGT
CAGTTTTTTTA -> AGTTTTTTTAG
TTCACCAGAGC -> TCACCAGAGCC
AGAGCTGACTT -> GAGCTGACTTG
GTGAGCTGTAT -> TGAGCTGTATG
TTTCATACAGA -> TTCATACAGAA
CTGCAGCTTAT -> TGCAGCTTATT
TAGAATATCTT -> AGAATATCTTC
GTAGACGCTAA -> TAGACGCTAAG
ACGTCGTTTAG -> CGTCGTTTAGA
AGATACATAGG -> GATACATAGGG
GTACCCGTTTT -> TACCCGTTTTA
TGCAACACTAA -> GCAACACTAAA
AAAGGACCGAG -> AAGGACCGAGT
ATACTCCTTCC -> TACTCCTTCCG
AATACAGAGTT -> ATACAGAGTTG
ACGAACTTGTT -> CGAACTTGTTG
CCCCGTGTGTG -> CCCGTGTGTGG
TGATAATGGCA -> GATAATGGCAA
AAGACGAACTT -> AGACGAACTTG
ACTTTGGCGGT -> CTTTGGCGGTA
GAGCTGACTTG -> AGCTGACTTGA
CGCGCTTTGTC -> GCGCTTTGTCT
GTTGTGGGCGG -> TTGTGGGCGGT
CTGATCAACGC -> TGATCAACGCT
TAAACCACTAT -> AAACCACTATA
ACGGTTCTTGC -> CGGTTCTTGCC
TTGGAAGCTTG -> TGGAAGCTTGT
CATTAGCCACA -> ATTAGCCACAG
TACTTATTCGC -> ACTTATTCGCG
ACCCAATCGTT -> CCCAATCGTTT
CAGACATACTC -> AGACATACTCC
GCGGGCTGCTT -> CGGGCTGCTTG
TGTATGGCCTA -> GTATGGCCTAG
CTTGAGTAAAG -> TTGAGTAAAGC
TCAATCATTCT -> CAATCATTCTA
TTATCTGCAGC -> TATCTGCAGCT
TGATCAACGCC -> GATCAACGCCA
TGTCATGTGAT -> GTCATGTGATC
AGTGTGCTCAT -> GTGTGCTCATT
CAGCGTGCCCA -> AGCGTGCCCAT
GCTCGGCGCAG -> CTCGGCGCAGT
CGTATATCAGG -> GTATATCAGGA
ATCAACGCCAT -> TCAACGCCATG
GCCTGGCTATG -> CCTGGCTATGG
TGTAAAACGAT -> GTAAAACGATC
GGCAATGAGTA -> GCAATGAGTAG
AGTAAAGCCGG -> GTAAAGCCGGA
TGCGGGCGGAA -> GCGGGCGGAAT
CGAAACGCCCT -> GAAACGCCCTT
CTAACACCGCC -> TAACACCGCCG
CCTAAGTATGC -> CTAAGTATGCA
TCCCTCACTAC -> CCCTCACTACT
ACCGAAACGCC -> CCGAAACGCCC
GGGATCTGCTA -> GGATCTGCTAA
TATGGGAGAGA -> ATGGGAGAGAC
TCTGTTACACA -> CTGTTACACAA
GGAATTTCTGA -> GAATTTCTGAC
CGACGGCGTCG -> GACGGCGTCGC
TATTCTTAAGA -> ATTCTTAAGAC
CCGAGTTGAGG -> CGAGTTGAGGG
GTCTTACTTGC -> TCTTACTTGCG
CGCGGGCGCCA -> GCGGGCGCCAG
ATGGCATCATA -> TGGCATCATAG
ATGGCAATCCT -> TGGCAATCCTA
ACGGTGTATGT -> CGGTGTATGTA
TTGTAGTCTTT -> TGTAGTCTTTA
ATGACGTGTTC -> TGACGTGTTCC
GAATCTAGACA -> AATCTAGACAC
TTCCAGTCTTA -> TCCAGTCTTAC
TCTCAGACATA -> CTCAGACATAC
AAAAGATAGAA -> AAAGATAGAAG
GTTTCCAGTCT -> TTTCCAGTCTT
ACATACTCCTT -> CATACTCCTTC
GGCGCCAGGCT -> GCGCCAGGCTG
GAATCGGGATC -> AATCGGGATCT
TACCGGTTTCT -> ACCGGTTTCTA
TACAGTAGACG -> ACAGTAGACGC
AGGTCTATGGT -> GGTCTATGGTG
TGGCCTAGTAG -> GGCCTAGTAGA
CTATCGGCTCG -> TATCGGCTCGC
CCGTTTGGTGG -> CGTTTGGTGGT
GTCAAGACCTA -> TCAAGACCTAA
CGTGCCCATCG -> GTGCCCATCGC
ACCTGGCCGTC -> CCTGGCCGTCT
AATGAAGACTA -> ATGAAGACTAG
ACTACGGCTAT -> CTACGGCTATA
TCGTAGATTTG -> CGTAGATTTGG
ATGGACGTTTA -> TGGACGTTTAT
TGTGGGCTCGG -> GTGGGCTCGGC
TGGGCGGTGTC -> GGGCGGTGTCA
AACTTGTTGGA -> ACTTGTTGGAT
GATCGAAGTAC -> ATCGAAGTACA
CTTCTCTGTTT -> TTCTCTGTTTT
TAACTCTTTCC -> AACTCTTTCCT
TCGGTTGTCCT -> CGGTTGTCCTC
ATCGAAGTACA -> TCGAAGTACAA
ATTTAGAGGTG -> TTTAGAGGTGT
TGATGGGCCAT -> GATGGGCCATC
CCTAAAAGATA -> CTAAAAGATAG
GTAAAGCCGGA -> TAAAGCCGGAG
TGTTCCTTTAA -> GTTCCTTTAAC
TTAGGTCTATG -> TAGGTCTATGG
AGACTAGAGGA -> GACTAGAGGAC
AAGGATACGAT -> AGGATACGATG
GTGTGGGCTCG -> TGTGGGCTCGG
CTCCTACTTGT -> TCCTACTTGTA
GCCGTCTATCT -> CCGTCTATCTA
GTATGTAAATC -> TATGTAAATCA
CAGAGTTTCCA -> AGAGTTTCCAG
AAGAACGCGCG -> AGAACGCGCGG
ATTCGCGTTGT -> TTCGCGTTGTG
TTGGATTTGGT -> TGGATTTGGTA
AACGCGCGGGC -> ACGCGCGGGCT
TTGACGGACTG -> TGACGGACTGG
CTGTAAGGATA -> TGTAAGGATAC
CGGACGACGGC -> GGACGACGGCG
TTCGCGTTGTG -> TCGCGTTGTGG
ATTAACAAGAC -> TTAACAAGACT
GATCAACGCCA -> ATCAACGCCAT
GCTGATTCTAC -> CTGATTCTACG
CAATCAGCATC -> AATCAGCATCG
GAGCCGTCTTT -> AGCCGTCTTTC
ATTTCATGCCG -> TTTCATGCCGT
TAGTCTTTACG -> AGTCTTTACGT
TCCGCCCCAGC -> CCGCCCCAGCT
GTGATCAATCA -> TGATCAATCAT
TACAATCAGCA -> ACAATCAGCAT
AAGTTCGGACG -> AGTTCGGACGA
TAGACGCTAAG -> AGACGCTAAGG
TCTGCTAAAGT -> CTGCTAAAGTT
TCCTATTCTAT -> CCTATTCTATT
TAGGGCGGGTA -> AGGGCGGGTAG
CCAGCTGGCCC -> CAGCTGGCCCT
AGGGCGGAACT -> GGGCGGAACTT
CTTACTTGCGG -> TTACTTGCGGG
TGTATCATAGC -> GTATCATAGCA
AACCGCCTAAA -> ACCGCCTAAAG
TCCTGCGTCGG -> CCTGCGTCGGA
CAGGGCTAACT -> AGGGCTAACTG
CGCGCGGGCTT -> GCGCGGGCTTA
CCCTCACTACT -> CCTCACTACTC
TGTGCTCATTG -> GTGCTCATTGC
CAGAGTTGCCC -> AGAGTTGCCCG
GTGTTCCTAGA -> TGTTCCTAGAT
CTACCATAACT -> TACCATAACTC
ACAGCGTGCCC -> CAGCGTGCCCA
ACCATAACTCT -> CCATAACTCTT
AGGCTTTCCGT -> GGCTTTCCGTC
ATGAGCCTGTA -> TGAGCCTGTAA
CCGTGTGTGGG -> CGTGTGTGGGC
ACTTCCAGGAA -> CTTCCAGGAAG
GTTTGGTGGTG -> TTTGGTGGTGA
CATCTACGTTA -> ATCTACGTTAC
TACTACGGCTA -> ACTACGGCTAT
AATCAGAGTTT -> ATCAGAGTTTC
GTGAGTGCATA -> TGAGTGCATAC
GTCTTACCATT -> TCTTACCATTT
CTGCGTCGGAT -> TGCGTCGGATT
TTCTTGCCACA -> TCTTGCCACAG
GCAGCTTATTG -> CAGCTTATTGT
TGTTCCTAGAT -> GTTCCTAGATA
TCGTTCTTTTA -> CGTTCTTTTAC
GCGTCTTATTT -> CGTCTTATTTT
TTTGTCTCTGT -> TTGTCTCTGTA
GAGCCTGTAAT -> AGCCTGTAATG
CATTGCCCCGT -> ATTGCCCCGTG
TGTTTTAAGGG -> GTTTTAAGGGA
CAATCATTCTA -> AATCATTCTAG
TCGCTGCGGGC -> CGCTGCGGGCG
GAGGATCAATC -> AGGATCAATCT
ACAGAAGACGC -> CAGAAGACGCG
GTTCTTTTACA -> TTCTTTTACAT
GATCTCTAACC -> ATCTCTAACCT
TGGACGTTTAT -> GGACGTTTATC
TTTAACCGGGC -> TTAACCGGGCC
TATGAACAATC -> ATGAACAATCA
GAGGACATCCA -> AGGACATCCAT
GGACGTCGCGC -> GACGTCGCGCT
GTTGCCCGTTT -> TTGCCCGTTTG
CGTGGCTGCTC -> GTGGCTGCTCC
TCTGGGGTCTA -> CTGGGGTCTAC
TACTTGTACTT -> ACTTGTACTTC
GAAGCTTGTAT -> AAGCTTGTATT
TAAAGCCGGAG -> AAAGCCGGAGG
CGCTTTGTCTC -> GCTTTGTCTCT
TGGGGTGGAAT -> GGGGTGGAATG
ATGGACAGTTG -> TGGACAGTTGA
GCGGTACCCGT -> CGGTACCCGTT
AAACACGCAAG -> AACACGCAAGG
CTTTACGTGAG -> TTTACGTGAGT
ACAGCGTCTTA -> CAGCGTCTTAT
ACACTCTGGCA -> CACTCTGGCAT
AACGGCCCTAA -> ACGGCCCTAAG
TCTGTATCATA -> CTGTATCATAG
CTATAGGCGCC -> TATAGGCGCCA
AGAGGACATCC -> GAGGACATCCA
CCCAGCTGGCC -> CCAGCTGGCCC
GGCGGAACTTG -> GCGGAACTTGC
AATCTTACAAT -> ATCTTACAATC
GTGGAATGCCG -> TGGAATGCCGT
AGAGACTACGA -> GAGACTACGAA
TCTCTAACCTG -> CTCTAACCTGG
GTAGTCGTAGA -> TAGTCGTAGAT
ATCTGCTAAAG -> TCTGCTAAAGT
GTAATGCACCG -> TAATGCACCGC
AACGGTGTATG -> ACGGTGTATGT
ACATTAGCCAC -> CATTAGCCACA
GGGTAGCAAAC -> GGTAGCAAACT
TCATGTGATCA -> CATGTGATCAA
TAAAAGATAGA -> AAAAGATAGAA
CAGCTGGCCCT -> AGCTGGCCCTT
AAGGTCAGTCC -> AGGTCAGTCCG
GTTCGGACGAC -> TTCGGACGACG
GGGGATTTAAC -> GGGATTTAACG
AGGAAGACGAA -> GGAAGACGAAC
AGTCAATTGTC -> GTCAATTGTCG
CTTGTACTTCC -> TTGTACTTCCA
TCTATGATTTC -> CTATGATTTCA
GTTTGTCTTAC -> TTTGTCTTACC
GTTGGTAAACA -> TTGGTAAACAC
ACATTTAACCG -> CATTTAACCGG
CTGTCCTTCTA -> TGTCCTTCTAT
GGCGCCATCTA -> GCGCCATCTAC
CTGGAATAAAC -> TGGAATAAACC
ATAAACCACTA -> TAAACCACTAT
TGGACAGTTGA -> GGACAGTTGAA
CCTTCTCTGTT -> CTTCTCTGTTT
GGATTTACTCT -> GATTTACTCTC
TGGTGATCAAT -> GGTGATCAATC
TGAGTCAAACG -> GAGTCAAACGC
AAGACCCAATC -> AGACCCAATCG
CGCCTAAAGGG -> GCCTAAAGGGA
ACTGCCAACGT -> CTGCCAACGTA
GCTCATTGCCC -> CTCATTGCCCC
GTTTATCTGCA -> TTTATCTGCAG
TAGAGGGTTGG -> AGAGGGTTGGC
CAGGATCTCTA -> AGGATCTCTAA
GTTGAAGATTT -> TTGAAGATTTC
GGTGTCATACA -> GTGTCATACAG
GTACGAATACA -> TACGAATACAT
GCAAAGATGCG -> CAAAGATGCGG
TAGGCGCCATC -> AGGCGCCATCT
ATAACTCTTTC -> TAACTCTTTCC
CCAGCTTGTCA -> CAGCTTGTCAA
GCAACGGCCCT -> CAACGGCCCTA
GCGGGCGGAAT -> CGGGCGGAATG
AAGGCGTGGCT -> AGGCGTGGCTA
GTTGTGGATCG -> TTGTGGATCGG
CGCCTGGCTAT -> GCCTGGCTATG
CGTCGCGGGCG -> GTCGCGGGCGC
AGACTGAGAAG -> GACTGAGAAGC
CCAAGTCTCAG -> CAAGTCTCAGA
GCGGAATGGAC -> CGGAATGGACA
CATCTGCCGCA -> ATCTGCCGCAT
CAGGAAGACGA -> AGGAAGACGAA
TGGGACGTCGC -> GGGACGTCGCG
GCGGAAGTTTG -> CGGAAGTTTGC
CAGAGTTGGTA -> AGAGTTGGTAA
TTCAGAGTTGG -> TCAGAGTTGGT
CTGTAATGCAC -> TGTAATGCACC
AATCATTCTAG -> ATCATTCTAGG
TGGTGGTGATC -> GGTGGTGATCA
GGGCGCCAGGC -> GGCGCCAGGCT
AGAAGCTAGTA -> GAAGCTAGTAG
GAAGACGAACT -> AAGACGAACTT
GCAAACTTGTT -> CAAACTTGTTG
GATCAATCATT -> ATCAATCATTC
GTTTTAAGGGA -> TTTTAAGGGAA
CTCCTTCCGCC -> TCCTTCCGCCC
AACGTATATCA -> ACGTATATCAG
TCTACGGAAAC -> CTACGGAAACT
GCAGACCGTGG -> CAGACCGTGGC
ACTATAGGAAT -> CTATAGGAATC
CTCTGGCATTC -> TCTGGCATTCG
GGTGGTGATCA -> GTGGTGATCAA
AGGTAGTGAAC -> GGTAGTGAACG
TTATGGGAGCC -> TATGGGAGCCG
TCTTTCATACA -> CTTTCATACAG
GAGTGCATACC -> AGTGCATACCA
CATAGTGAGAC -> ATAGTGAGACC
CGCTACTTATT -> GCTACTTATTC
CACCGATTCTA -> ACCGATTCTAT
AGACGGCCCCT -> GACGGCCCCTG
CTGCTCCAGGC -> TGCTCCAGGCT
CGGCAATGAGT -> GGCAATGAGTA
AAAAATCTGGG -> AAAATCTGGGG
TTAACGATCGC -> TAACGATCGCG
GTATTCACAAC -> TATTCACAACA
CTCGCTGCGGG -> TCGCTGCGGGC
TACCCGTTTTA -> ACCCGTTTTAC
ATTCTTAAGAC -> TTCTTAAGACC
CAGCGTCTTAT -> AGCGTCTTATT
CTTACAATCAG -> TTACAATCAGC
TAGATTTGGAA -> AGATTTGGAAG
CCCCAGCTGGC -> CCCAGCTGGCC
CCTTCTATGGC -> CTTCTATGGCA
AGACATACTCC -> GACATACTCCT
ATGGGGATTTA -> TGGGGATTTAA
GGATCAATCTA -> GATCAATCTAT
GAGAGACTACG -> AGAGACTACGA
CCCTCGGTACG -> CCTCGGTACGA
GTCATACAGGA -> TCATACAGGAT
ATGGCCTAGTA -> TGGCCTAGTAG
CTATAGGAATC -> TATAGGAATCG
ATAACCGCCTA -> TAACCGCCTAA
AGCTAGTAGTG -> GCTAGTAGTGC
CCTTTCCCTCA -> CTTTCCCTCAC
CCGAACAGCGT -> CGAACAGCGTG
ATTCTATAGGC -> TTCTATAGGCG
ATCATAGCATC -> TCATAGCATCC
CTAGTAGTGCA -> TAGTAGTGCAG
CCTTTAACGGT -> CTTTAACGGTT
CAACTGTAAGG -> AACTGTAAGGA
CGATTATCGGT -> GATTATCGGTT
ACTTTCTACTA -> CTTTCTACTAC
CCGTATTAACA -> CGTATTAACAA
GGTGGAATGCC -> GTGGAATGCCG
GCATTCGTTCT -> CATTCGTTCTT
AACACCGCCGT -> ACACCGCCGTC
GCTAAGGTTCA -> CTAAGGTTCAA
GTACTCCAGGT -> TACTCCAGGTT
GTAAATCAGAC -> TAAATCAGACG
CGACTGTCCTT -> GACTGTCCTTC
AGATAGAAGCA -> GATAGAAGCAA
AGGCTAAGCTG -> GGCTAAGCTGA
CAGAAGACGCG -> AGAAGACGCGG
GCCGTATTCAC -> CCGTATTCACA
CCAATCGTTTA -> CAATCGTTTAG
AATCCTATTCT -> ATCCTATTCTA
ATTTTGTAGTC -> TTTTGTAGTCT
CTTCCAGGAAG -> TTCCAGGAAGA
ATACATAGGGC -> TACATAGGGCG
GAAGCTAGTAG -> AAGCTAGTAGT
TCTTAAGACCC -> CTTAAGACCCA
GGCTTTCCGTC -> GCTTTCCGTCC
GAAGAACGCGC -> AAGAACGCGCG
ATAGGAATCGG -> TAGGAATCGGG
GGTCAGTCCGC -> GTCAGTCCGCT
GTTTAGATGAG -> TTTAGATGAGC
CTGGAGTTAGA -> TGGAGTTAGAG
TCCTGAGTCAA -> CCTGAGTCAAA
GTACAGTAGAC -> TACAGTAGACG
TTTACCGAACA -> TTACCGAACAG
ATGATCGAAGT -> TGATCGAAGTA
TTCCGTCCTAG -> TCCGTCCTAGG
TTGAAGATTTC -> TGAAGATTTCG
GCGCAACGGCC -> CGCAACGGCCC
AGTTGAAGATT -> GTTGAAGATTT
GGGGTAGCAAA -> GGGTAGCAAAC
TTAACCGGGCC -> TAACCGGGCCG
TTGCTACCAGT -> TGCTACCAGTC
TACATAGGGCG -> ACATAGGGCGG
GCTATAGGGTA -> CTATAGGGTAG
TAGGCTAAGCT -> AGGCTAAGCTG
ACTGACTTGTG -> CTGACTTGTGC
CAAGTCTCAGA -> AAGTCTCAGAC
GAATGCCGTAT -> AATGCCGTATT
GGAGGGCGGAA -> GAGGGCGGAAC
GTAGGATGTTC -> TAGGATGTTCA
GTGTCATGTGA -> TGTCATGTGAT
TTATTTTGTAG -> TATTTTGTAGT
AATGCACCGCG -> ATGCACCGCGC
CTACGGAAACT -> TACGGAAACTC
TGGCAATCCTA -> GGCAATCCTAT
TGATCAATCAT -> GATCAATCATT
GTCAGAAATCT -> TCAGAAATCTT
AGTCTTTACGT -> GTCTTTACGTG
ATACCATGAGC -> TACCATGAGCC
GTAGTCTTTAC -> TAGTCTTTACG
GACGGCGTCGC -> ACGGCGTCGCG
GTACAAAGGAC -> TACAAAGGACC
GGAATGGACAG -> GAATGGACAGT
AGGTGTCATAC -> GGTGTCATACA
TTTGATAATGG -> TTGATAATGGC
TATAGGAATCG -> ATAGGAATCGG
TTCGTAGTGAG -> TCGTAGTGAGC
GCTCGCTGCGG -> CTCGCTGCGGG
GCCACAGTTTG -> CCACAGTTTGA
TCTGGGGTGGA -> CTGGGGTGGAA
GAAACTCCCCC -> AAACTCCCCCT
TTGAGGGAGGG -> TGAGGGAGGGC
CTCGCCCGACT -> TCGCCCGACTG
GATTCTAATGA -> ATTCTAATGAA
TTCTAGGTAGA -> TCTAGGTAGAG
TAACCGCCTAA -> AACCGCCTAAA
CTTGCCACAGT -> TTGCCACAGTT
GTTTAGCCAAA -> TTTAGCCAAAA
ATCTCTAACCT -> TCTCTAACCTG
AGAGGATCAAT -> GAGGATCAATC
TGAGTAGGATG -> GAGTAGGATGT
CGTATGACGTG -> GTATGACGTGT
TGCCGCATTTT -> GCCGCATTTTT
TAGGATGTTCA -> AGGATGTTCAC
CAGTCTTACTT -> AGTCTTACTTG
TACCATTTCAG -> ACCATTTCAGA
ATCTTCATAGT -> TCTTCATAGTG
AATCTATGGAC -> ATCTATGGACG
GTAAAACGATC -> TAAAACGATCG
AGGCTGATTCT -> GGCTGATTCTA
TTCTACGGAAA -> TCTACGGAAAC
GTCTTATTTTG -> TCTTATTTTGT
TTCACAACATC -> TCACAACATCA
GCTTTGTCTCT -> CTTTGTCTCTG
GAGCTGTATGG -> AGCTGTATGGG
GTTGAAGAACG -> TTGAAGAACGC
GGAATCGGGAT -> GAATCGGGATC
CAATTGTCGAC -> AATTGTCGACT
CGGCCCTAAGT -> GGCCCTAAGTA
TATTGTTCCTT -> ATTGTTCCTTT
CTTTCCGTCCT -> TTTCCGTCCTA
CGGTGTATGTA -> GGTGTATGTAA
AGCGTCTTATT -> GCGTCTTATTT
ACTTGAGTAAA -> CTTGAGTAAAG
TTGAAGAACGC -> TGAAGAACGCG
TTAGATGAGCC -> TAGATGAGCCC
ACGCGCGGGCT -> CGCGCGGGCTT
TAGTGAGACCT -> AGTGAGACCTG
GGTGTATGTAA -> GTGTATGTAAA
GCTAGTAGTGC -> CTAGTAGTGCA
CATCATAGTGT -> ATCATAGTGTG
TTGTGGATCGG -> TGTGGATCGGT
ACGCTCCTACT -> CGCTCCTACTT
ATCTAACACCG -> TCTAACACCGC
TACTCTCGCCC -> ACTCTCGCCCG
CTGAGTCATCT -> TGAGTCATCTG
GCTAAGCTGAT -> CTAAGCTGATC
GATCCTGCGTC -> ATCCTGCGTCG
GGGCTAACTGC -> GGCTAACTGCC
ATTTTTCTGGG -> TTTTTCTGGGG
GAGTAAAGCCG -> AGTAAAGCCGG
CAACGCTCCTA -> AACGCTCCTAC
CATACAGGATC -> ATACAGGATCT
ATACAGAGTTG -> TACAGAGTTGA
AGGGTTGGCAT -> GGGTTGGCATT
AGCTGTATGGG -> GCTGTATGGGA
TAGTCGTAGAT -> AGTCGTAGATT
AACGGTTCTTG -> ACGGTTCTTGC
GGCCGATTATC -> GCCGATTATCG
CGCCATCTACG -> GCCATCTACGT
GATTTCGTAGT -> ATTTCGTAGTG
GGAAACTCCCC -> GAAACTCCCCC
TCTGGCATTCG -> CTGGCATTCGT
GCTGCTTGACG -> CTGCTTGACGG
CCTGGCCGTCT -> CTGGCCGTCTA
CTGCTAAAGTT -> TGCTAAAGTTC
TTCATGCCGTC -> TCATGCCGTCG
AGTAGACGCTA -> GTAGACGCTAA
CTCTCTCTGTT -> TCTCTCTGTTA
CTATGATTTCA -> TATGATTTCAT
TTCACATAACC -> TCACATAACCG
GACCGTGGCTG -> ACCGTGGCTGC
CAGTAGACGCT -> AGTAGACGCTA
ATCTGGGGTGG -> TCTGGGGTGGA
ATAGTGAGACC -> TAGTGAGACCT
CGGGCGGAATG -> GGGCGGAATGG
GGTGTCATGTG -> GTGTCATGTGA
GGACGACGGCG -> GACGACGGCGT
AAGAATCTAGA -> AGAATCTAGAC
AAACCGAAACG -> AACCGAAACGC
GGGCTGAGTCA -> GGCTGAGTCAT
GCTGAGTCATC -> CTGAGTCATCT
GAGGCTTTCCG -> AGGCTTTCCGT
GTCTTTACGTG -> TCTTTACGTGA
ACTTGTTGTGG -> CTTGTTGTGGG
CGCCATGTGTA -> GCCATGTGTAA
TTTGGTGGTGA -> TTGGTGGTGAT
CTTTCATACAG -> TTTCATACAGA
AGGACATCCAT -> GGACATCCATG
TTCTGGGGTCT -> TCTGGGGTCTA
TATGTAAATCA -> ATGTAAATCAG
CGGAATGGACA -> GGAATGGACAG
TCGCGCTTTGT -> CGCGCTTTGTC
CTTGTCAAGAC -> TTGTCAAGACC
ACTCCATGTTT -> CTCCATGTTTA
ACCGTGGCTGC -> CCGTGGCTGCT
TCTATGGACGT -> CTATGGACGTT
GCGGGCTGAGT -> CGGGCTGAGTC
TGCTCCAGGCT -> GCTCCAGGCTG
TTGGTACTACG -> TGGTACTACGG
GGCTCGGCGCA -> GCTCGGCGCAG
CGGAAGTTTGC -> GGAAGTTTGCT
TTTAGAGGTGT -> TTAGAGGTGTC
GACTTGAGTAA -> ACTTGAGTAAA
CTAAGCTGATC -> TAAGCTGATCA
CGGCCCCTGGG -> GGCCCCTGGGA
TCCTAGGCTAA -> CCTAGGCTAAG
CCATTTCAGAG -> CATTTCAGAGT
TGACAGCGTCT -> GACAGCGTCTT
CGTTACCCTCG -> GTTACCCTCGT
ACAGTAGACGC -> CAGTAGACGCT
TGTCAAGACCT -> GTCAAGACCTA
TGTGGATCGGT -> GTGGATCGGTG
CCTGAGTCAAA -> CTGAGTCAAAC
AGCAAACTTGT -> GCAAACTTGTT
GGTTGGCATTA -> GTTGGCATTAA
TATCGGCTCGC -> ATCGGCTCGCT
TGTGTGGGCTC -> GTGTGGGCTCG
CCGTCTTTCAT -> CGTCTTTCATA
AAGTATGCAAC -> AGTATGCAACA
ATATCAGGAAC -> TATCAGGAACG
GTATGCAACAC -> TATGCAACACT
TGTATGTAAAT -> GTATGTAAATC
CTCCAGGTTTG -> TCCAGGTTTGT
GTTTTTTTAGG -> TTTTTTTAGGT
TCAGACGGCCC -> CAGACGGCCCC
TATTAACAAGA -> ATTAACAAGAC
CAGAGCCGTAT -> AGAGCCGTATT
CGGGCTTAATC -> GGGCTTAATCC
AAGACTGAGAA -> AGACTGAGAAG
TGGATTTGGTA -> GGATTTGGTAC
GTCTACCATAA -> TCTACCATAAC
TAACAAGACTT -> AACAAGACTTT
GGGCGGGTAGC -> GGCGGGTAGCC
CTGAGAAGCTA -> TGAGAAGCTAG
ATAGGGTAGTC -> TAGGGTAGTCG
CTTAATCCTGA -> TTAATCCTGAG
TATCTTCATAG -> ATCTTCATAGT
TCGAATATGAA -> CGAATATGAAC
TGCAGAGTTGC -> GCAGAGTTGCC
TCAAGAATCTA -> CAAGAATCTAG
CTGATGGGCCA -> TGATGGGCCAT
AAGGTTCAAGA -> AGGTTCAAGAA
TACGAATACAT -> ACGAATACATT
AGAGGGTTGGC -> GAGGGTTGGCA
ACCAGAGGATC -> CCAGAGGATCA
TTTTCACATAA -> TTTCACATAAC
ATATGAACAAT -> TATGAACAATC
TTTAGCCAAAA -> TTAGCCAAAAA
CGATGATCGAA -> GATGATCGAAG
GAGTTAGAGCT -> AGTTAGAGCTG
TCGAAGTACAA -> CGAAGTACAAA
AGAGTTGCCCG -> GAGTTGCCCGT
AGAATATCTTC -> GAATATCTTCA
GACTTTCTACT -> ACTTTCTACTA
TGACCAACTGT -> GACCAACTGTA
CATTTCAGAGT -> ATTTCAGAGTT
CGTTTACCGAA -> GTTTACCGAAC
TACTCTGTATC -> ACTCTGTATCA
CGCATTTTTCT -> GCATTTTTCTG
TGAAGAACGCG -> GAAGAACGCGC
GGTTTCTATCG -> GTTTCTATCGG
GCTGTATGGGA -> CTGTATGGGAT
GCGCGGGCTTA -> CGCGGGCTTAA
GTATGACGTGT -> TATGACGTGTT
CGGAAACTCCC -> GGAAACTCCCC
GGACGTTTATC -> GACGTTTATCT
GGCGGTACCCG -> GCGGTACCCGT
CAGAAATCTTA -> AGAAATCTTAC
AGTCGTAGATT -> GTCGTAGATTT
GCCATCTCGCT -> CCATCTCGCTC
AGCTTGTATTT -> GCTTGTATTTA
TCGCGGGCGCC -> CGCGGGCGCCA
AGTATGCAACA -> GTATGCAACAC
AACGCCATGTG -> ACGCCATGTGT
CTACTACCCCA -> TACTACCCCAG
AATAAACCACT -> ATAAACCACTA
ATTTGGAAGCT -> TTTGGAAGCTT
GAAATCTTACA -> AAATCTTACAA
GGTCTACCATA -> GTCTACCATAA
CTGCTTGACGG -> TGCTTGACGGA
GGGTAGTCGTA -> GGTAGTCGTAG
CCAACTGTAAG -> CAACTGTAAGG
GTGCATACCAT -> TGCATACCATG
TCAGGGCTAAC -> CAGGGCTAACT
CGCTCTCTCTG -> GCTCTCTCTGT
GGTACCCGTTT -> GTACCCGTTTT
CTAGGCTAAGC -> TAGGCTAAGCT
GAGACTACGAA -> AGACTACGAAC
GACCCAATCGT -> ACCCAATCGTT
TTGTGCGTGCG -> TGTGCGTGCGG
GCCGTCGAATA -> CCGTCGAATAT
TGGGGATTTAA -> GGGGATTTAAC
GCATTAATACA -> CATTAATACAG
TACCCCAGCTG -> ACCCCAGCTGG
ACCGGGCCGAT -> CCGGGCCGATT
GCGGGGTAGCA -> CGGGGTAGCAA
TCTTACTTGCG -> CTTACTTGCGG
AGACCTAAAAG -> GACCTAAAAGA
TATTCGCGTTG -> ATTCGCGTTGT
GAACGCTGAGA -> AACGCTGAGAT
GTTCCTTTAAC -> TTCCTTTAACG
CTAGACACTCT -> TAGACACTCTG
ACAGTTTGATA -> CAGTTTGATAA
GAGTCATCTGC -> AGTCATCTGCC
GCCGTCTTTCA -> CCGTCTTTCAT
CCCTTTCCCTC -> CCTTTCCCTCA
TCATACAGAAG -> CATACAGAAGA
ATCAGTCAGAA -> TCAGTCAGAAA
GCGCAGTGTAC -> CGCAGTGTACT
GCGCCAGGCTG -> CGCCAGGCTGA
CTCTGTTACAC -> TCTGTTACACA
ATTTGGTACTA -> TTTGGTACTAC
CGCGCAACGGC -> GCGCAACGGCC
GTATGGGATTT -> TATGGGATTTA
TCTAATGAAGA -> CTAATGAAGAC
ATCTACGTTAC -> TCTACGTTACC
CCTCGCGGCAA -> CTCGCGGCAAT
AGTTCGGACGA -> GTTCGGACGAC
CTCCAGGCTGA -> TCCAGGCTGAC
CGGGCCGATTA -> GGGCCGATTAT
CTACCCCAGCT -> TACCCCAGCTG
TGCGGGGTAGC -> GCGGGGTAGCA
GGGCTTAATCC -> GGCTTAATCCT
CTTTTACATTT -> TTTTACATTTA
TATTCTATTAT -> ATTCTATTATC
CTAGATACATA -> TAGATACATAG
GCTGGCCCTTT -> CTGGCCCTTTC
GAGTCAAACGC -> AGTCAAACGCT
AGAAGCAAAGA -> GAAGCAAAGAT
CCGGACTCCAT -> CGGACTCCATG
ACGGCCCTAAG -> CGGCCCTAAGT
TCCATGGGGAT -> CCATGGGGATT
TCTAGACACTC -> CTAGACACTCT
ATGAACAATCA -> TGAACAATCAG
GGATCGGTGGA -> GATCGGTGGAA
GTGTATGTAAA -> TGTATGTAAAT
ACGTGTTCCTA -> CGTGTTCCTAG
CGGTACCCGTT -> GGTACCCGTTT
CTGGGGTGGAA -> TGGGGTGGAAT
GACAGTTGAAG -> ACAGTTGAAGA
GTAGTGCAGAG -> TAGTGCAGAGT
CCGTTTTACCG -> CGTTTTACCGG
CCAGAGCCGTA -> CAGAGCCGTAT
CCTGGAGTATC -> CTGGAGTATCT
TAAGGATACGA -> AAGGATACGAT
GAGAAGCTAGT -> AGAAGCTAGTA
GTTGAGGGAGG -> TTGAGGGAGGG
CGAATATGAAC -> GAATATGAACA
TTTTAAGGGAA -> TTTAAGGGAAT
ACGTGAGTGCA -> CGTGAGTGCAT
CATGTTTATGG -> ATGTTTATGGG
TACCCTCGTAT -> ACCCTCGTATG
GTATTTAGAGG -> TATTTAGAGGT
GGTAGTCGTAG -> GTAGTCGTAGA
GTGGGCTCGGC -> TGGGCTCGGCG
AAACGCCCTTC -> AACGCCCTTCT
CCATGTTTATG -> CATGTTTATGG
GTAGTGAACGG -> TAGTGAACGGT
ACTGGAGTTAG -> CTGGAGTTAGA
CTGGCTATGGG -> TGGCTATGGGA
GACGGACTGGA -> ACGGACTGGAG
TGTGATCAACG -> GTGATCAACGC
TCCTGATGGGC -> CCTGATGGGCC
GCCACAGTTTT -> CCACAGTTTTT
TTAACGGTTCT -> TAACGGTTCTT
TGTCCTCGCGG -> GTCCTCGCGGC
GCTAAGGTAGT -> CTAAGGTAGTG
TGGCATTCGTT -> GGCATTCGTTC
GGTTGTCCTCG -> GTTGTCCTCGC
CAATGAGTAGG -> AATGAGTAGGA
ACATCCATGGG -> CATCCATGGGG
GCCGTATTAAC -> CCGTATTAACA
ATAGCATCCAA -> TAGCATCCAAG
CCAGTCTTACT -> CAGTCTTACTT
TTTACGTGAGT -> TTACGTGAGTG
ACGGACTGGAG -> CGGACTGGAGT
TACAAAGGACC -> ACAAAGGACCG
AGACGAACTTG -> GACGAACTTGT
TATCAGGAACG -> ATCAGGAACGC
TACACAAGTTC -> ACACAAGTTCA
TCATAGCATCC -> CATAGCATCCA
GAGTTGGTAAA -> AGTTGGTAAAC
CCTGATGGGCC -> CTGATGGGCCA
TAGGAATCGGG -> AGGAATCGGGA
CTTGACGGACT -> TTGACGGACTG
AAGCTTGTATT -> AGCTTGTATTT
CTGGGGTCTAC -> TGGGGTCTACC
ATAGGCGCCAT -> TAGGCGCCATC
TCAGTCAGAAA -> CAGTCAGAAAT
TTTCTACTACC -> TTCTACTACCC
AGCCACCAGAG -> GCCACCAGAGG
AAATCAGACGG -> AATCAGACGGC
AGTGCATACCA -> GTGCATACCAT
TGCATACCATG -> GCATACCATGA
AATTGTCGACT -> ATTGTCGACTT
CCGTCGTTTAC -> CGTCGTTTACC
ATGCCGTATTC -> TGCCGTATTCA
TCGCTACTTAT -> CGCTACTTATT
CATAACCGCCT -> ATAACCGCCTA
GCCGATTATCG -> CCGATTATCGG
TTGTTCCTTTA -> TGTTCCTTTAA
TTTTTCTGGGG -> TTTTCTGGGGT
TCCAGGCTGAC -> CCAGGCTGACC
GGAGTATCTCT -> GAGTATCTCTA
GGACCGAGTTG -> GACCGAGTTGA
CAGGCTGATTC -> AGGCTGATTCT
TGAACGGTGTA -> GAACGGTGTAT
TAGAGCTGACT -> AGAGCTGACTT
ATACAGGATCT -> TACAGGATCTC
TTAACAAGACT -> TAACAAGACTT
TCCGTCCTAGG -> CCGTCCTAGGC
CGAACTTGTTG -> GAACTTGTTGG
TGTATTTAGAG -> GTATTTAGAGG
TCAGACATACT -> CAGACATACTC
AGCCGTATTAA -> GCCGTATTAAC
CACATAACCGC -> ACATAACCGCC
AAGGACCGAGT -> AGGACCGAGTT
ACCCTCGTATG -> CCCTCGTATGA
TCGCCCGACTG -> CGCCCGACTGT
TCCATGTTTAT -> CCATGTTTATG
TTAATACAGAG -> TAATACAGAGT
CGCCAGGCTGA -> GCCAGGCTGAT
ATTCTAGGTAG -> TTCTAGGTAGA
TCGGCGCAGTG -> CGGCGCAGTGT
CGGGGTAGCAA -> GGGGTAGCAAA
CTAATGAAGAC -> TAATGAAGACT
GAGTTGCCCGT -> AGTTGCCCGTT
TGCGGTCAAGG -> GCGGTCAAGGC
ACTGTCCTTCT -> CTGTCCTTCTA
GTGCGGAAGTT -> TGCGGAAGTTT
TTCTATCGGCT -> TCTATCGGCTC
AGCATCCAAGT -> GCATCCAAGTC
AAACCACTATA -> AACCACTATAG
TTACGTGAGTG -> TACGTGAGTGC
CCGCCCCAGCT -> CGCCCCAGCTT
GGAAGCTTGTA -> GAAGCTTGTAT
CTGACAGCGTC -> TGACAGCGTCT
TTTTACATTTA -> TTTACATTTAA
GCAGTGTACTC -> CAGTGTACTCC
GTCAAACGCTG -> TCAAACGCTGG
TGTGCGTGCGG -> GTGCGTGCGGA
GGGCTCGGCGC -> GGCTCGGCGCA
GTGAACGGTGT -> TGAACGGTGTA
GTCAGTCCGCT -> TCAGTCCGCTG
AACTCCCCCTC -> ACTCCCCCTCG
TGTTTATGGGA -> GTTTATGGGAG
AATCAGCATCG -> ATCAGCATCGC
TTTAGGTCTAT -> TTAGGTCTATG
GACTTGTGCGT -> ACTTGTGCGTG
CCGGAGGCTTT -> CGGAGGCTTTC
TATCTAACACC -> ATCTAACACCG
GGATTTAACGA -> GATTTAACGAT
GTAGATTTGGA -> TAGATTTGGAA
GGATTCTAATG -> GATTCTAATGA
CCTGGGACGTC -> CTGGGACGTCG
GTTTTCACATA -> TTTTCACATAA
TATGGGATTTA -> ATGGGATTTAC
CCGGTTTCTAT -> CGGTTTCTATC
AGAACGCGCGG -> GAACGCGCGGG
AATATCTTCAT -> ATATCTTCATA
CCCGTGTGTGG -> CCGTGTGTGGG
CCTAAAGGGAA -> CTAAAGGGAAT
CGGGCTGCTTG -> GGGCTGCTTGA
CGCCCTTCTCT -> GCCCTTCTCTG
ATGGGAGCCGT -> TGGGAGCCGTC
GACGCTAAGGT -> ACGCTAAGGTA
GAAGTACAAAG -> AAGTACAAAGG
GTGTGCTCATT -> TGTGCTCATTG
TTTCTGGGGTC -> TTCTGGGGTCT
GGCCCTAAGTA -> GCCCTAAGTAT
TCATGCCGTCG -> CATGCCGTCGT
GTCCTAGGCTA -> TCCTAGGCTAA
TGGCTATGGGA -> GGCTATGGGAG
TCATTCTAGGT -> CATTCTAGGTA
GTCAATTGTCG -> TCAATTGTCGA
TTGCGGGGTAG -> TGCGGGGTAGC
AATCGGGATCT -> ATCGGGATCTG
GCTGACTTGAG -> CTGACTTGAGT
AGTCAAACGCT -> GTCAAACGCTG
CTGGAGTATCT -> TGGAGTATCTC
CGTATTCACAA -> GTATTCACAAC
AGCTGACTTGA -> GCTGACTTGAG
ATCAGAGTTTC -> TCAGAGTTTCC
AACGCTCCTAC -> ACGCTCCTACT
GCTCCAGGCTG -> CTCCAGGCTGA
TTTCATGCCGT -> TTCATGCCGTC
AGACCGTGGCT -> GACCGTGGCTG
AGTCTCAGACA -> GTCTCAGACAT
GCGTGGCTAAG -> CGTGGCTAAGG
GCCGCATTTTT -> CCGCATTTTTC
CAGTTTGATAA -> AGTTTGATAAT
ATGCGGGCTGA -> TGCGGGCTGAG
GATTATCGGTT -> ATTATCGGTTG
TGACGGACTGG -> GACGGACTGGA
TTTTGTAGTCT -> TTTGTAGTCTT
ATCGGCTCGCT -> TCGGCTCGCTG
TGTATGGGATT -> GTATGGGATTT
TGCACCGCGCA -> GCACCGCGCAG
CCGGGCCGATT -> CGGGCCGATTA
AGCCGTCTTTC -> GCCGTCTTTCA
CATACTCCTTC -> ATACTCCTTCC
CGGAACTTGCG -> GGAACTTGCGG
GTAGCAAACTT -> TAGCAAACTTG
CTGTTACACAA -> TGTTACACAAG
CCGATTCTATA -> CGATTCTATAG
CGCAGACCGTG -> GCAGACCGTGG
TCCAGGAAGAC -> CCAGGAAGACG
GCAGAGTTGCC -> CAGAGTTGCCC
TAAGTATGCAA -> AAGTATGCAAC
CTGTATCATAG -> TGTATCATAGC
TATTTAGAGGT -> ATTTAGAGGTG
TCGGGATCTGC -> CGGGATCTGCT
GTCTTTCATAC -> TCTTTCATACA
ACCGGTTTCTA -> CCGGTTTCTAT
GAAGCAAAGAT -> AAGCAAAGATG
TCGCGGCAATG -> CGCGGCAATGA
ATTCTATTATC -> TTCTATTATCA
TACTACCCCAG -> ACTACCCCAGC
CTGACTTGAGT -> TGACTTGAGTA
GTGTACTCCAG -> TGTACTCCAGG
GAACTTGTTGG -> AACTTGTTGGA
CTTGTTGTGGG -> TTGTTGTGGGC
TAGAGGACATC -> AGAGGACATCC
CCCAATCGTTT -> CCAATCGTTTA
CGGACTGGAGT -> GGACTGGAGTT
CGACTTTGGCG -> GACTTTGGCGG
CGGTTGTCCTC -> GGTTGTCCTCG
TGATTTCATGC -> GATTTCATGCC
GACGGCCCCTG -> ACGGCCCCTGG
CGCTATTCTTA -> GCTATTCTTAA
TAACTGCCAAC -> AACTGCCAACG
TCCTTTAACGG -> CCTTTAACGGT
GCTTGTATTTA -> CTTGTATTTAG
TCAAGGCGTGG -> CAAGGCGTGGC
GGCTGACCAAC -> GCTGACCAACT
ATTTAACGATC -> TTTAACGATCG
GAGTTTCCAGT -> AGTTTCCAGTC
GAACGCGCGGG -> AACGCGCGGGC
CACAAGTTCAC -> ACAAGTTCACG
ATTTCTGACAG -> TTTCTGACAGC
GTAGAGGGTTG -> TAGAGGGTTGG
CTCTATGATTT -> TCTATGATTTC
CACGCAAGGTC -> ACGCAAGGTCA
ACCTAAAAGAT -> CCTAAAAGATA
TAAGCTGATCA -> AAGCTGATCAA
TTGTTGTGGGC -> TGTTGTGGGCG
TAATCCTGAGT -> AATCCTGAGTC
GAATAAACCAC -> AATAAACCACT
CTCTTTCCTGA -> TCTTTCCTGAT
GTGGAAGACTG -> TGGAAGACTGA
TCTGTACAGTA -> CTGTACAGTAG
TGGAAGCTTGT -> GGAAGCTTGTA
ACTCTGTATCA -> CTCTGTATCAT
TTCCCTCACTA -> TCCCTCACTAC
TCTCTGTTTTA -> CTCTGTTTTAA
CGCTGAGATCC -> GCTGAGATCCT
TCTTTCCTGAT -> CTTTCCTGATG
TGCGGGCTGAG -> GCGGGCTGAGT
TAAAGGGAATT -> AAAGGGAATTT
TGGTAAACACG -> GGTAAACACGC
GTCGTAGATTT -> TCGTAGATTTG
AGGGCTAACTG -> GGGCTAACTGC
TATCAGTCAGA -> ATCAGTCAGAA
CAACATCAGGG -> AACATCAGGGC
CTACGGCTATA -> TACGGCTATAG
AAGTCTCAGAC -> AGTCTCAGACA
CAAGACTTTCT -> AAGACTTTCTA
GCGGCAATGAG -> CGGCAATGAGT
TGAGCCTGTAA -> GAGCCTGTAAT
AGATTTGGAAG -> GATTTGGAAGC
ACGGCTATAGG -> CGGCTATAGGG
ACCACTATAGG -> CCACTATAGGA
CAAGTTCACGT -> AAGTTCACGTC
TCCAGTCTTAC -> CCAGTCTTACT
GATCGGTGGAA -> ATCGGTGGAAG
GCGCTTTGTCT -> CGCTTTGTCTC
AGTGCAGAGTT -> GTGCAGAGTTG
GGTGGAAGACT -> GTGGAAGACTG
TGCCAACGTAT -> GCCAACGTATA
CACCGCGCAGA -> ACCGCGCAGAC
TCTTGCCACAG -> CTTGCCACAGT
CTCATTGCCCC -> TCATTGCCCCG
ACATCAGGGCT -> CATCAGGGCTA
CTGAGATCCTG -> TGAGATCCTGC
CAGTGTACTCC -> AGTGTACTCCA
GGTAGTGAACG -> GTAGTGAACGG
CAAACGCTGGA -> AAACGCTGGAA
TGAGACCTGGC -> GAGACCTGGCC
ATCAGACGGCC -> TCAGACGGCCC
TCGCGCTATTC -> CGCGCTATTCT
AGTTGAAGAAC -> GTTGAAGAACG
TTAATCCTGAG -> TAATCCTGAGT
GAATGGACAGT -> AATGGACAGTT
GTCCGCTGTTT -> TCCGCTGTTTT
TCTTTTACATT -> CTTTTACATTT
TCACCGATTCT -> CACCGATTCTA
GCTAAAGTTCG -> CTAAAGTTCGG
GCCCGACTGTC -> CCCGACTGTCC
GGCTGAGTCAT -> GCTGAGTCATC
TCAAACGCTGG -> CAAACGCTGGA
CGCTGTTTTCA -> GCTGTTTTCAC
TTTCGTAGTGA -> TTCGTAGTGAG
TGAGATCCTGC -> GAGATCCTGCG
CGTGTTCCTAG -> GTGTTCCTAGA
TGCGTCGGATT -> GCGTCGGATTC
CGAATACATTA -> GAATACATTAG
GCCACCAGAGG -> CCACCAGAGGA
CTAAAGGGAAT -> TAAAGGGAATT
AGAAGACGCGG -> GAAGACGCGGG
TCAGCATCGCT -> CAGCATCGCTA
CTGCCAACGTA -> TGCCAACGTAT
TACGATGATCG -> ACGATGATCGA
CTATGGGAGAG -> TATGGGAGAGA
CATGGGGATTT -> ATGGGGATTTA
TGTGGGCGGTG -> GTGGGCGGTGT
TCGGTACGAAT -> CGGTACGAATA
TTTAAGGGAAT -> TTAAGGGAATC
TAGATGAGCCC -> AGATGAGCCCG
TTAGCCAAAAA -> TAGCCAAAAAT
CTTACCATTTC -> TTACCATTTCA
CTTTAACGGTT -> TTTAACGGTTC
CTAAAAGATAG -> TAAAAGATAGA
CTCGCTCTCTC -> TCGCTCTCTCT
TCCTAGATACA -> CCTAGATACAT
AAGACTAGAGG -> AGACTAGAGGA
CGGGCGCCAGG -> GGGCGCCAGGC
ATTAGCCACAG -> TTAGCCACAGT
TCTTCATAGTG -> CTTCATAGTGA
GTTTGCTACCA -> TTTGCTACCAG
CTCTAACCTGG -> TCTAACCTGGA
GCTCCTACTTG -> CTCCTACTTGT
TTAAGGGAATC -> TAAGGGAATCA
AGGCTGACCAA -> GGCTGACCAAC
GCATTTTTCTG -> CATTTTTCTGG
CTAAGTATGCA -> TAAGTATGCAA
GAGCCGTATTA -> AGCCGTATTAA
CCGCCGTCGAA -> CGCCGTCGAAT
TACAGAAGACG -> ACAGAAGACGC
CCTGCGTCGGA -> CTGCGTCGGAT
TGTACTTCCAG -> GTACTTCCAGG
GTGTCATACAG -> TGTCATACAGG
TCAGAAATCTT -> CAGAAATCTTA
GCCGGAGGCTT -> CCGGAGGCTTT
TAGACACTCTG -> AGACACTCTGG
AATATGAACAA -> ATATGAACAAT
GCGGTGTCATG -> CGGTGTCATGT
GCCCATCGCCT -> CCCATCGCCTG
TCAGAGTTGGT -> CAGAGTTGGTA
CTCGGTACGAA -> TCGGTACGAAT
GGTGATCAATC -> GTGATCAATCA
ATGGGATTTAC -> TGGGATTTACT
CCTTCCGCCCC -> CTTCCGCCCCA
ATCATAGTGTG -> TCATAGTGTGC
CAGTCAGAAAT -> AGTCAGAAATC
AAGCTGATCAA -> AGCTGATCAAC
TACGGAAACTC -> ACGGAAACTCC
TTCCTAGATAC -> TCCTAGATACA
CTATCTAACAC -> TATCTAACACC
TACTTCCAGGA -> ACTTCCAGGAA
CTGCGGGCGGA -> TGCGGGCGGAA
TACCATGAGCC -> ACCATGAGCCT
ACTTGTACTTC -> CTTGTACTTCC
CTATAGGGTAG -> TATAGGGTAGT
GACTAGAGGAC -> ACTAGAGGACA
AAACTCCCCCT -> AACTCCCCCTC
CCATCTACGTT -> CATCTACGTTA
TCTAACCTGGA -> CTAACCTGGAG
CTAAGGTAGTG -> TAAGGTAGTGA
AGTTTCCAGTC -> GTTTCCAGTCT
CTTCCGCCCCA -> TTCCGCCCCAG
ACCTGGAGTAT -> CCTGGAGTATC
GTTTATGGGAG -> TTTATGGGAGC
TCACCAGAGCC -> CACCAGAGCCG
CTATTATCAGT -> TATTATCAGTC
GGGCGGAATGG -> GGCGGAATGGA
ACGTTTATCTG -> CGTTTATCTGC
CGTTTATCTGC -> GTTTATCTGCA
AAAGCCGGAGG -> AAGCCGGAGGC
TCAAGACCTAA -> CAAGACCTAAA
TGGCGGTACCC -> GGCGGTACCCG
CATGTGATCAA -> ATGTGATCAAC
CTGGCCCTTTC -> TGGCCCTTTCC
GCCCCAGCTTG -> CCCCAGCTTGT
AGGCGTGGCTA -> GGCGTGGCTAA
ATCTATGGACG -> TCTATGGACGT
TCACAACATCA -> CACAACATCAG
CAAAGATGCGG -> AAAGATGCGGG
CTTATTTTGTA -> TTATTTTGTAG
CGTCGCGCTAT -> GTCGCGCTATT
TCCTTCCGCCC -> CCTTCCGCCCC
TAGCCACCAGA -> AGCCACCAGAG
GAGGGTTGGCA -> AGGGTTGGCAT
CACCAGAGCCG -> ACCAGAGCCGT
CCGTCCTAGGC -> CGTCCTAGGCT
CGGGATCTGCT -> GGGATCTGCTA
GGCTATGGGAG -> GCTATGGGAGA
CATACCATGAG -> ATACCATGAGC
ACAAGACTTTC -> CAAGACTTTCT
CCTCACTACTC -> CTCACTACTCT
CATTAATACAG -> ATTAATACAGA
TTTTTAGGTCT -> TTTTAGGTCTA
ACCAGAGCCGT -> CCAGAGCCGTA
ACCATTTCAGA -> CCATTTCAGAG
CCGATTATCGG -> CGATTATCGGT
TCAGGAACGCT -> CAGGAACGCTG
TATGCAACACT -> ATGCAACACTA
TTGAGTAAAGC -> TGAGTAAAGCC
GGCTGCTTGAC -> GCTGCTTGACG
CGCGCTATTCT -> GCGCTATTCTT
CTGGCCGTCTA -> TGGCCGTCTAT
AAGTTTGCTAC -> AGTTTGCTACC
GCTTGTCAAGA -> CTTGTCAAGAC
TTACTCTCGCC -> TACTCTCGCCC
TCCTTCTATGG -> CCTTCTATGGC
TAACACCGCCG -> AACACCGCCGT
TAGGTCTATGG -> AGGTCTATGGT
TTTCTGACAGC -> TTCTGACAGCG
GATTTGGTACT -> ATTTGGTACTA
TGGCTGCTCCA -> GGCTGCTCCAG
TAGGTAGAGGG -> AGGTAGAGGGT
GGTAAACACGC -> GTAAACACGCA
GTGGCTAAGGT -> TGGCTAAGGTT
ACTACGAACTG -> CTACGAACTGA
GTCTCTGTACA -> TCTCTGTACAG
CAATCCTATTC -> AATCCTATTCT
TCAGTCCGCTG -> CAGTCCGCTGT
TTCATACAGAA -> TCATACAGAAG
GAGTATCTCTA -> AGTATCTCTAT
GAGGGAGGGCG -> AGGGAGGGCGG
AGTAGAATATC -> GTAGAATATCT
GACTACGAACT -> ACTACGAACTG
ACCAACTGTAA -> CCAACTGTAAG
GTTACACAAGT -> TTACACAAGTT
ACCGCCGTCGA -> CCGCCGTCGAA
CCACAGTTTGA -> CACAGTTTGAT
CATCCATGGGG -> ATCCATGGGGA
GTCGCGCTATT -> TCGCGCTATTC
GAACTGACTTG -> AACTGACTTGT
TAGTGCAGAGT -> AGTGCAGAGTT
CGTCTATCTAA -> GTCTATCTAAC
CTCTGTTTTAA -> TCTGTTTTAAG
TATCGGTTGTC -> ATCGGTTGTCC
CGATCGCGCTT -> GATCGCGCTTT
TACATTTAACC -> ACATTTAACCG
TCTATGGTGTA -> CTATGGTGTAT
AGGGAATTTCT -> GGGAATTTCTG
AAAGTTCGGAC -> AAGTTCGGACG
TGTCGACTTTG -> GTCGACTTTGG
TTTAGATGAGC -> TTAGATGAGCC
TTGCCCCGTGT -> TGCCCCGTGTG
GGTCTATGGTG -> GTCTATGGTGT
AAACGCTGGAA -> AACGCTGGAAT
TCGTAGTGAGC -> CGTAGTGAGCT
AGGTCAGTCCG -> GGTCAGTCCGC
TAGAGGTGTCA -> AGAGGTGTCAT
GGTTCAAGAAT -> GTTCAAGAATC
TAATGGCAATC -> AATGGCAATCC
GACGACGGCGT -> ACGACGGCGTC
GCATACCATGA -> CATACCATGAG
ATTGTCGACTT -> TTGTCGACTTT
AGTTTGATAAT -> GTTTGATAATG
GCCAAAAATCT -> CCAAAAATCTG
CCAACGTATAT -> CAACGTATATC
CTAGTAGAATA -> TAGTAGAATAT
TACAGGATCTC -> ACAGGATCTCT
TTGTCTTACCA -> TGTCTTACCAT
GCTGTTTTCAC -> CTGTTTTCACA
CGTTTGGTGGT -> GTTTGGTGGTG
GGCTTAATCCT -> GCTTAATCCTG
CCGCGCAGACC -> CGCGCAGACCG
ATGAAGACTAG -> TGAAGACTAGA
TGCTTGACGGA -> GCTTGACGGAC
AGCCGGAGGCT -> GCCGGAGGCTT
TTCCTTTAACG -> TCCTTTAACGG
AAGGGAATCAC -> AGGGAATCACC
TGAAGATTTCG -> GAAGATTTCGT
CCTACTTGTAC -> CTACTTGTACT
TGACTTGTGCG -> GACTTGTGCGT
TGCGGAAGTTT -> GCGGAAGTTTG
ATGCACCGCGC -> TGCACCGCGCA
TCCAAGTCTCA -> CCAAGTCTCAG
CCGCATTTTTC -> CGCATTTTTCT
CCACCAGAGGA -> CACCAGAGGAT
TTCCAGGAAGA -> TCCAGGAAGAC
TCTTTACGTGA -> CTTTACGTGAG
AAACGATCGCG -> AACGATCGCGC
TTCATAGTGAG -> TCATAGTGAGA
CGAACAGCGTG -> GAACAGCGTGC
TGGAATAAACC -> GGAATAAACCA
ATATCTTCATA -> TATCTTCATAG
GGCGTGGCTAA -> GCGTGGCTAAG
ATCTGCAGCTT -> TCTGCAGCTTA
GGGAATTTCTG -> GGAATTTCTGA
GGCCTAGTAGA -> GCCTAGTAGAA
CACCAGAGGAT -> ACCAGAGGATC
CCAGAGGATCA -> CAGAGGATCAA
GGGTTGGCATT -> GGTTGGCATTA
TCAATTGTCGA -> CAATTGTCGAC
GCGCTATTCTT -> CGCTATTCTTA
CTGAGTCAAAC -> TGAGTCAAACG
GTGTATGGCCT -> TGTATGGCCTA
GGAGCCGTCTT -> GAGCCGTCTTT
CAAAAATCTGG -> AAAAATCTGGG
TGTAAGGATAC -> GTAAGGATACG
GCTATTCTTAA -> CTATTCTTAAG
GCAAGGTCAGT -> CAAGGTCAGTC
GCAATGAGTAG -> CAATGAGTAGG
ACAGGATCTCT -> CAGGATCTCTA
TACCATAACTC -> ACCATAACTCT
CCCCCTCGGTA -> CCCCTCGGTAC
AAGCAAAGATG -> AGCAAAGATGC
TTACCGGTTTC -> TACCGGTTTCT
GGTTTGTCTTA -> GTTTGTCTTAC
GCCGTCGTTTA -> CCGTCGTTTAC
GGGAGCCGTCT -> GGAGCCGTCTT
CGTCGTTTAGA -> GTCGTTTAGAT
AGTGAGCTGTA -> GTGAGCTGTAT
CCACAGTTTTT -> CACAGTTTTTT
GCTGGAATAAA -> CTGGAATAAAC
TCATAGTGAGA -> CATAGTGAGAC
CCCCTGGGACG -> CCCTGGGACGT
GAGTTGAAGAT -> AGTTGAAGATT
AACCGAAACGC -> ACCGAAACGCC
CCTGGCTATGG -> CTGGCTATGGG
AGCTTATTGTT -> GCTTATTGTTC
GGAACTTGCGG -> GAACTTGCGGT
TCTAACACCGC -> CTAACACCGCC
GCTATGGGAGA -> CTATGGGAGAG
GTATGGCCTAG -> TATGGCCTAGT
CATGCCGTCGT -> ATGCCGTCGTT
CGTCCTAGGCT -> GTCCTAGGCTA
TCTATTATCAG -> CTATTATCAGT
CCACTATAGGA -> CACTATAGGAA
ATTCGTTCTTT -> TTCGTTCTTTT
GGCCCTTTCCC -> GCCCTTTCCCT
GTGGATCGGTG -> TGGATCGGTGG
AGAGTTGAAGA -> GAGTTGAAGAT
AGCCTGTAATG -> GCCTGTAATGC
TTTGGTACTAC -> TTGGTACTACG
CGTTTTACCGG -> GTTTTACCGGT
GAATACATTAG -> AATACATTAGC
TCGGACGACGG -> CGGACGACGGC
TAGTGAACGGT -> AGTGAACGGTG
GCTGCTCCAGG -> CTGCTCCAGGC
TCTGCAGCTTA -> CTGCAGCTTAT
ACGCCATGTGT -> CGCCATGTGTA
CAAAGGACCGA -> AAAGGACCGAG
CCCATCGCCTG -> CCATCGCCTGG
GTCGAATATGA -> TCGAATATGAA
AGAGGTGTCAT -> GAGGTGTCATA
CGCAACGGCCC -> GCAACGGCCCT
TTACCATTTCA -> TACCATTTCAG
GCGCAGACCGT -> CGCAGACCGTG
AGGAATCGGGA -> GGAATCGGGAT
ACTCCAGGTTT -> CTCCAGGTTTG
ATGAGCCCGAT -> TGAGCCCGATT
AAGGGAATTTC -> AGGGAATTTCT
TGTTGGATTTG -> GTTGGATTTGG
AGTATCTCTAT -> GTATCTCTATG
GCTGATCAACG -> CTGATCAACGC
TTTGCTACCAG -> TTGCTACCAGT
AAGACTTTCTA -> AGACTTTCTAC
CGATCGCGCAA -> GATCGCGCAAC
GAGTTGAGGGA -> AGTTGAGGGAG
CCATCGCCTGG -> CATCGCCTGGC
CTCACTACTCT -> TCACTACTCTG
GACGCGGGCTG -> ACGCGGGCTGC
TAAGGTTCAAG -> AAGGTTCAAGA
CTAAGGTTCAA -> TAAGGTTCAAG
ATCCATGGGGA -> TCCATGGGGAT
AGCCACAGTTT -> GCCACAGTTTT
ATCCTGAGTCA -> TCCTGAGTCAA
CCCTCGTATGA -> CCTCGTATGAC
GTTCTTGCCAC -> TTCTTGCCACA
ACAAAGGACCG -> CAAAGGACCGA
GCCCCGTGTGT -> CCCCGTGTGTG
TCGTTTAGCCA -> CGTTTAGCCAA
TTACATTTAAC -> TACATTTAACC
CTATGGTGTAT -> TATGGTGTATG
ATCCTATTCTA -> TCCTATTCTAT
GCTTTCCGTCC -> CTTTCCGTCCT
TGCGTGCGGAA -> GCGTGCGGAAG
TAAAGTTCGGA -> AAAGTTCGGAC
CGGTTTCTATC -> GGTTTCTATCG
TAAGGTAGTGA -> AAGGTAGTGAA
TGTAAATCAGA -> GTAAATCAGAC
TGATTCTACGG -> GATTCTACGGA
ACACAAGTTCA -> CACAAGTTCAC
CTTATTGTTCC -> TTATTGTTCCT
CTCTCTGTTAC -> TCTCTGTTACA
CAAGGCGTGGC -> AAGGCGTGGCT
GGATACGATGA -> GATACGATGAT
ACGTATATCAG -> CGTATATCAGG
TCTTATTTTGT -> CTTATTTTGTA
GGGCGGAACTT -> GGCGGAACTTG
GTGCGTGCGGA -> TGCGTGCGGAA
GCGTCGCGGGC -> CGTCGCGGGCG
CCCTAAGTATG -> CCTAAGTATGC
CTACTTATTCG -> TACTTATTCGC
CTAACCTGGAG -> TAACCTGGAGT
GATAATGGCAA -> ATAATGGCAAT
GTTTCTATCGG -> TTTCTATCGGC
GACAGCGTCTT -> ACAGCGTCTTA
TCGCTCTCTCT -> CGCTCTCTCTG
CAGAGGATCAA -> AGAGGATCAAT
GCCAACGTATA -> CCAACGTATAT
CGAACTGACTT -> GAACTGACTTG
GGCTAAGGTTC -> GCTAAGGTTCA
CGGACTCCATG -> GGACTCCATGT
CGTATTAACAA -> GTATTAACAAG
CATACAGAAGA -> ATACAGAAGAC
TCGTATGACGT -> CGTATGACGTG
GACTTTGGCGG -> ACTTTGGCGGT
ACCGATTCTAT -> CCGATTCTATA
TCTGTTTTAAG -> CTGTTTTAAGG
GATACGATGAT -> ATACGATGATC
CCTAGTAGAAT -> CTAGTAGAATA
AATCACCGATT -> ATCACCGATTC
AAAACGATCGC -> AAACGATCGCG
CAAGAATCTAG -> AAGAATCTAGA
ACACTAAACCG -> CACTAAACCGA
TATCTCTATGA -> ATCTCTATGAT
CCATCTCGCTC -> CATCTCGCTCT
GCTTATTGTTC -> CTTATTGTTCC
CTCTCGCCCGA -> TCTCGCCCGAC
TATTATCAGTC -> ATTATCAGTCA
GCAACACTAAA -> CAACACTAAAC
TCTACGTTACC -> CTACGTTACCC
TGGCATCATAG -> GGCATCATAGT
CAGGTTTGTCT -> AGGTTTGTCTT
ACACCGCCGTC -> CACCGCCGTCG
GGGATTTAACG -> GGATTTAACGA
AAAGATGCGGG -> AAGATGCGGGC
TTCCGCCCCAG -> TCCGCCCCAGC
TTTATGGGAGC -> TTATGGGAGCC
TCTATAGGCGC -> CTATAGGCGCC
GGCTCGCTGCG -> GCTCGCTGCGG
ACGTCGCGCTA -> CGTCGCGCTAT
AGTTTTTTTAG -> GTTTTTTTAGG
GTAGAATATCT -> TAGAATATCTT
TTGCCCGTTTG -> TGCCCGTTTGG
AGTTGAGGGAG -> GTTGAGGGAGG
GTAAGGATACG -> TAAGGATACGA
TTCAAGAATCT -> TCAAGAATCTA
GGCATCATAGT -> GCATCATAGTG
GCACCGCGCAG -> CACCGCGCAGA
GGGCGGTGTCA -> GGCGGTGTCAT
ACTCCTTCCGC -> CTCCTTCCGCC
CTTTCCCTCAC -> TTTCCCTCACT
AGTCATCTGCC -> GTCATCTGCCG
AAGACGCGGGC -> AGACGCGGGCT
GCATCGCTACT -> CATCGCTACTT
AAATCTTACAA -> AATCTTACAAT
TCACGTCGTTT -> CACGTCGTTTA
GTTGTCCTCGC -> TTGTCCTCGCG
ATCAGCATCGC -> TCAGCATCGCT
CAAACTTGTTG -> AAACTTGTTGT
CGTGCGGAAGT -> GTGCGGAAGTT
TCGGTGGAAGA -> CGGTGGAAGAC
AATACATTAGC -> ATACATTAGCC
TTTTTTAGGTC -> TTTTTAGGTCT
CGCTAAGGTAG -> GCTAAGGTAGT
GTGGCTGCTCC -> TGGCTGCTCCA
CAGCATCGCTA -> AGCATCGCTAC
CTTAAGACCCA -> TTAAGACCCAA
TCCTCGCGGCA -> CCTCGCGGCAA
GTGCCCATCGC -> TGCCCATCGCC
ATCGCCTGGCT -> TCGCCTGGCTA
GAACAGCGTGC -> AACAGCGTGCC
TTCTATAGGCG -> TCTATAGGCGC
GATTCTATAGG -> ATTCTATAGGC
ACGGAAACTCC -> CGGAAACTCCC
TATGGGAGCCG -> ATGGGAGCCGT
ATCTTACAATC -> TCTTACAATCA
ACAGTTTTTTT -> CAGTTTTTTTA
CTATGGCATCA -> TATGGCATCAT
CGTGTGTGGGC -> GTGTGTGGGCT
